ar-az | ara_Arab-aze_Latn
ar-be | ara_Arab-bel_Cyrl
ar-bg | ara_Arab-bul_Cyrl
ar-bn | ara_Arab-ben_Beng
ar-bs | ara_Arab-bos_Latn
ar-ca | ara_Arab-cat_Latn
ar-cs | ara_Arab-ces_Latn
ar-da | ara_Arab-dan_Latn
ar-de | ara_Arab-deu_Latn
ar-el | ara_Arab-ell_Grek
ar-en | ara_Arab-eng_Latn
ar-es_419 | ara_Arab-spa_Latn
ar-es | ara_Arab-spa_Latn
ar-es_ES | ara_Arab-spa_Latn
ar-et | ara_Arab-est_Latn
ar-eu | ara_Arab-eus_Latn
ar-fa | ara_Arab-fas_Arab
ar-fi | ara_Arab-fin_Latn
ar-fr | ara_Arab-fra_Latn
ar-gl | ara_Arab-glg_Latn
ar-he | ara_Arab-heb_Hebr
ar-hi | ara_Arab-hin_Deva
ar-hr | ara_Arab-hrv_Latn
ar-hu | ara_Arab-hun_Latn
ar-hy | ara_Arab-hye_Armn
ar-id | ara_Arab-ind_Latn
ar-is | ara_Arab-isl_Latn
ar-it | ara_Arab-ita_Latn
ar-ka | ara_Arab-kat_Geor
ar-kk | ara_Arab-kaz_Cyrl
ar-km | ara_Arab-khm_Khmr
ar-kn | ara_Arab-kan_Knda
ar-ko | ara_Arab-kor_Hang
ar-ku | ara_Arab-kmr_Latn
ar-lt | ara_Arab-lit_Latn
ar-lv | ara_Arab-lav_Latn
ar-mk | ara_Arab-mkd_Cyrl
ar-ml | ara_Arab-mal_Mlym
ar-mn | ara_Arab-mon_Cyrl
ar-ms | ara_Arab-msa_Latn
ar-my | ara_Arab-mya_Mymr
ar-nl | ara_Arab-nld_Latn
ar-no | ara_Arab-nob_Latn
ar-pl | ara_Arab-pol_Latn
ar-ps | ara_Arab-pus_Arab
ar-pt | ara_Arab-por_Latn
ar-pt_BR | ara_Arab-por_Latn
ar-pt_MZ | ara_Arab-por_Latn
ar-ro | ara_Arab-ron_Latn
ar-ru | ara_Arab-rus_Cyrl
ar-si | ara_Arab-sin_Sinh
ar-sk | ara_Arab-slk_Latn
ar-sl | ara_Arab-slv_Latn
ar-sq | ara_Arab-sqi_Latn
ar-sr | ara_Arab-srp_Cyrl
ar-sv | ara_Arab-swe_Latn
ar-sw | ara_Arab-swa_Latn
ar-ta | ara_Arab-tam_Taml
ar-te | ara_Arab-tel_Telu
ar-tl | ara_Arab-tgl_Latn
ar-tr | ara_Arab-tur_Latn
ar-tt | ara_Arab-tat_Cyrl
ar-uk | ara_Arab-ukr_Cyrl
ar-ur | ara_Arab-urd_Arab
ar-uz | ara_Arab-uzb_Latn
ar-vi | ara_Arab-vie_Latn
ar-yue | ara_Arab-yue_Hant
ar-zh_CN | ara_Arab-zho_Hans
ar-zh_TW | ara_Arab-zho_Hant
ar-zh_ze | ara_Arab-zho_Hans
az-bg | aze_Latn-bul_Cyrl
az-bn | aze_Latn-ben_Beng
az-bs | aze_Latn-bos_Latn
az-cs | aze_Latn-ces_Latn
az-da | aze_Latn-dan_Latn
az-de | aze_Latn-deu_Latn
az-el | aze_Latn-ell_Grek
az-en | aze_Latn-eng_Latn
az-es_419 | aze_Latn-spa_Latn
az-es | aze_Latn-spa_Latn
az-es_ES | aze_Latn-spa_Latn
az-et | aze_Latn-est_Latn
az-fa | aze_Latn-fas_Arab
az-fi | aze_Latn-fin_Latn
az-fr | aze_Latn-fra_Latn
az-he | aze_Latn-heb_Hebr
az-hr | aze_Latn-hrv_Latn
az-hu | aze_Latn-hun_Latn
az-id | aze_Latn-ind_Latn
az-is | aze_Latn-isl_Latn
az-it | aze_Latn-ita_Latn
az-ko | aze_Latn-kor_Hang
az-ku | aze_Latn-kmr_Latn
az-lt | aze_Latn-lit_Latn
az-lv | aze_Latn-lav_Latn
az-mk | aze_Latn-mkd_Cyrl
az-ml | aze_Latn-mal_Mlym
az-ms | aze_Latn-msa_Latn
az-my | aze_Latn-mya_Mymr
az-nl | aze_Latn-nld_Latn
az-no | aze_Latn-nob_Latn
az-pl | aze_Latn-pol_Latn
az-pt | aze_Latn-por_Latn
az-pt_BR | aze_Latn-por_Latn
az-ro | aze_Latn-ron_Latn
az-ru | aze_Latn-rus_Cyrl
az-si | aze_Latn-sin_Sinh
az-sk | aze_Latn-slk_Latn
az-sl | aze_Latn-slv_Latn
az-sq | aze_Latn-sqi_Latn
az-sr | aze_Latn-srp_Cyrl
az-sv | aze_Latn-swe_Latn
az-tr | aze_Latn-tur_Latn
az-tt | aze_Latn-tat_Cyrl
az-uk | aze_Latn-ukr_Cyrl
az-vi | aze_Latn-vie_Latn
az-yue | aze_Latn-yue_Hant
az-zh_CN | aze_Latn-zho_Hans
az-zh_TW | aze_Latn-zho_Hant
az-zh_ze | aze_Latn-zho_Hans
be-bg | bel_Cyrl-bul_Cyrl
be-bn | bel_Cyrl-ben_Beng
be-bs | bel_Cyrl-bos_Latn
be-cs | bel_Cyrl-ces_Latn
be-da | bel_Cyrl-dan_Latn
be-de | bel_Cyrl-deu_Latn
be-el | bel_Cyrl-ell_Grek
be-en | bel_Cyrl-eng_Latn
be-es_419 | bel_Cyrl-spa_Latn
be-es | bel_Cyrl-spa_Latn
be-es_ES | bel_Cyrl-spa_Latn
be-et | bel_Cyrl-est_Latn
be-eu | bel_Cyrl-eus_Latn
be-fa | bel_Cyrl-fas_Arab
be-fi | bel_Cyrl-fin_Latn
be-fr | bel_Cyrl-fra_Latn
be-gl | bel_Cyrl-glg_Latn
be-he | bel_Cyrl-heb_Hebr
be-hi | bel_Cyrl-hin_Deva
be-hr | bel_Cyrl-hrv_Latn
be-hu | bel_Cyrl-hun_Latn
be-id | bel_Cyrl-ind_Latn
be-is | bel_Cyrl-isl_Latn
be-it | bel_Cyrl-ita_Latn
be-ko | bel_Cyrl-kor_Hang
be-ku | bel_Cyrl-kmr_Latn
be-lt | bel_Cyrl-lit_Latn
be-lv | bel_Cyrl-lav_Latn
be-mk | bel_Cyrl-mkd_Cyrl
be-ml | bel_Cyrl-mal_Mlym
be-ms | bel_Cyrl-msa_Latn
be-nl | bel_Cyrl-nld_Latn
be-no | bel_Cyrl-nob_Latn
be-pl | bel_Cyrl-pol_Latn
be-pt | bel_Cyrl-por_Latn
be-pt_BR | bel_Cyrl-por_Latn
be-ro | bel_Cyrl-ron_Latn
be-ru | bel_Cyrl-rus_Cyrl
be-si | bel_Cyrl-sin_Sinh
be-sk | bel_Cyrl-slk_Latn
be-sl | bel_Cyrl-slv_Latn
be-sq | bel_Cyrl-sqi_Latn
be-sr | bel_Cyrl-srp_Cyrl
be-sv | bel_Cyrl-swe_Latn
be-ta | bel_Cyrl-tam_Taml
be-te | bel_Cyrl-tel_Telu
be-tr | bel_Cyrl-tur_Latn
be-uk | bel_Cyrl-ukr_Cyrl
be-vi | bel_Cyrl-vie_Latn
be-zh_CN | bel_Cyrl-zho_Hans
be-zh_TW | bel_Cyrl-zho_Hant
be-zh_ze | bel_Cyrl-zho_Hans
bg-bg | bul_Cyrl-bul_Cyrl
bg-bn | bul_Cyrl-ben_Beng
bg-bs | bul_Cyrl-bos_Latn
bg-ca | bul_Cyrl-cat_Latn
bg-cs | bul_Cyrl-ces_Latn
bg-da | bul_Cyrl-dan_Latn
bg-de | bul_Cyrl-deu_Latn
bg-el | bul_Cyrl-ell_Grek
bg-en | bul_Cyrl-eng_Latn
bg-en_ze | bul_Cyrl-eng_Latn
bg-es_419 | bul_Cyrl-spa_Latn
bg-es | bul_Cyrl-spa_Latn
bg-es_ES | bul_Cyrl-spa_Latn
bg-et | bul_Cyrl-est_Latn
bg-eu | bul_Cyrl-eus_Latn
bg-fa | bul_Cyrl-fas_Arab
bg-fi | bul_Cyrl-fin_Latn
bg-fr | bul_Cyrl-fra_Latn
bg-gl | bul_Cyrl-glg_Latn
bg-he | bul_Cyrl-heb_Hebr
bg-hi | bul_Cyrl-hin_Deva
bg-hr | bul_Cyrl-hrv_Latn
bg-hu | bul_Cyrl-hun_Latn
bg-id | bul_Cyrl-ind_Latn
bg-is | bul_Cyrl-isl_Latn
bg-it | bul_Cyrl-ita_Latn
bg-ka | bul_Cyrl-kat_Geor
bg-km | bul_Cyrl-khm_Khmr
bg-kn | bul_Cyrl-kan_Knda
bg-ko | bul_Cyrl-kor_Hang
bg-ku | bul_Cyrl-kmr_Latn
bg-lt | bul_Cyrl-lit_Latn
bg-lv | bul_Cyrl-lav_Latn
bg-mk | bul_Cyrl-mkd_Cyrl
bg-ml | bul_Cyrl-mal_Mlym
bg-mn | bul_Cyrl-mon_Cyrl
bg-ms | bul_Cyrl-msa_Latn
bg-my | bul_Cyrl-mya_Mymr
bg-nl | bul_Cyrl-nld_Latn
bg-no | bul_Cyrl-nob_Latn
bg-pl | bul_Cyrl-pol_Latn
bg-pt | bul_Cyrl-por_Latn
bg-pt_BR | bul_Cyrl-por_Latn
bg-ro | bul_Cyrl-ron_Latn
bg-ru | bul_Cyrl-rus_Cyrl
bg-si | bul_Cyrl-sin_Sinh
bg-sk | bul_Cyrl-slk_Latn
bg-sl | bul_Cyrl-slv_Latn
bg-sq | bul_Cyrl-sqi_Latn
bg-sr | bul_Cyrl-srp_Cyrl
bg-sv | bul_Cyrl-swe_Latn
bg-sw | bul_Cyrl-swa_Latn
bg-ta | bul_Cyrl-tam_Taml
bg-te | bul_Cyrl-tel_Telu
bg-tl | bul_Cyrl-tgl_Latn
bg-tr | bul_Cyrl-tur_Latn
bg-tt | bul_Cyrl-tat_Cyrl
bg-uk | bul_Cyrl-ukr_Cyrl
bg-ur | bul_Cyrl-urd_Arab
bg-uz | bul_Cyrl-uzb_Latn
bg-vi | bul_Cyrl-vie_Latn
bg-yue | bul_Cyrl-yue_Hant
bg-zh_CN | bul_Cyrl-zho_Hans
bg-zh_TW | bul_Cyrl-zho_Hant
bg-zh_ze | bul_Cyrl-zho_Hans
bn-bn | ben_Beng-ben_Beng
bn-bs | ben_Beng-bos_Latn
bn-ca | ben_Beng-cat_Latn
bn-cs | ben_Beng-ces_Latn
bn-da | ben_Beng-dan_Latn
bn-de | ben_Beng-deu_Latn
bn-el | ben_Beng-ell_Grek
bn-en | ben_Beng-eng_Latn
bn-es_419 | ben_Beng-spa_Latn
bn-es | ben_Beng-spa_Latn
bn-es_ES | ben_Beng-spa_Latn
bn-et | ben_Beng-est_Latn
bn-eu | ben_Beng-eus_Latn
bn-fa | ben_Beng-fas_Arab
bn-fi | ben_Beng-fin_Latn
bn-fr | ben_Beng-fra_Latn
bn-gl | ben_Beng-glg_Latn
bn-he | ben_Beng-heb_Hebr
bn-hi | ben_Beng-hin_Deva
bn-hr | ben_Beng-hrv_Latn
bn-hu | ben_Beng-hun_Latn
bn-id | ben_Beng-ind_Latn
bn-is | ben_Beng-isl_Latn
bn-it | ben_Beng-ita_Latn
bn-km | ben_Beng-khm_Khmr
bn-kn | ben_Beng-kan_Knda
bn-ko | ben_Beng-kor_Hang
bn-ku | ben_Beng-kmr_Latn
bn-lt | ben_Beng-lit_Latn
bn-lv | ben_Beng-lav_Latn
bn-mk | ben_Beng-mkd_Cyrl
bn-ml | ben_Beng-mal_Mlym
bn-ms | ben_Beng-msa_Latn
bn-my | ben_Beng-mya_Mymr
bn-nl | ben_Beng-nld_Latn
bn-no | ben_Beng-nob_Latn
bn-pl | ben_Beng-pol_Latn
bn-ps | ben_Beng-pus_Arab
bn-pt | ben_Beng-por_Latn
bn-pt_BR | ben_Beng-por_Latn
bn-ro | ben_Beng-ron_Latn
bn-ru | ben_Beng-rus_Cyrl
bn-si | ben_Beng-sin_Sinh
bn-sk | ben_Beng-slk_Latn
bn-sl | ben_Beng-slv_Latn
bn-sq | ben_Beng-sqi_Latn
bn-sr | ben_Beng-srp_Cyrl
bn-sv | ben_Beng-swe_Latn
bn-sw | ben_Beng-swa_Latn
bn-ta | ben_Beng-tam_Taml
bn-te | ben_Beng-tel_Telu
bn-tl | ben_Beng-tgl_Latn
bn-tr | ben_Beng-tur_Latn
bn-tt | ben_Beng-tat_Cyrl
bn-uk | ben_Beng-ukr_Cyrl
bn-ur | ben_Beng-urd_Arab
bn-vi | ben_Beng-vie_Latn
bn-yue | ben_Beng-yue_Hant
bn-zh_CN | ben_Beng-zho_Hans
bn-zh_TW | ben_Beng-zho_Hant
bn-zh_ze | ben_Beng-zho_Hans
bs-bs | bos_Latn-bos_Latn
bs-ca | bos_Latn-cat_Latn
bs-cs | bos_Latn-ces_Latn
bs-da | bos_Latn-dan_Latn
bs-de | bos_Latn-deu_Latn
bs-el | bos_Latn-ell_Grek
bs-en | bos_Latn-eng_Latn
bs-en_ze | bos_Latn-eng_Latn
bs-es_419 | bos_Latn-spa_Latn
bs-es | bos_Latn-spa_Latn
bs-es_ES | bos_Latn-spa_Latn
bs-et | bos_Latn-est_Latn
bs-eu | bos_Latn-eus_Latn
bs-fa | bos_Latn-fas_Arab
bs-fi | bos_Latn-fin_Latn
bs-fr | bos_Latn-fra_Latn
bs-gl | bos_Latn-glg_Latn
bs-he | bos_Latn-heb_Hebr
bs-hi | bos_Latn-hin_Deva
bs-hr | bos_Latn-hrv_Latn
bs-hu | bos_Latn-hun_Latn
bs-id | bos_Latn-ind_Latn
bs-is | bos_Latn-isl_Latn
bs-it | bos_Latn-ita_Latn
bs-ka | bos_Latn-kat_Geor
bs-kn | bos_Latn-kan_Knda
bs-ko | bos_Latn-kor_Hang
bs-ku | bos_Latn-kmr_Latn
bs-lt | bos_Latn-lit_Latn
bs-lv | bos_Latn-lav_Latn
bs-mk | bos_Latn-mkd_Cyrl
bs-ml | bos_Latn-mal_Mlym
bs-ms | bos_Latn-msa_Latn
bs-my | bos_Latn-mya_Mymr
bs-nl | bos_Latn-nld_Latn
bs-no | bos_Latn-nob_Latn
bs-pl | bos_Latn-pol_Latn
bs-pt_BR | bos_Latn-por_Latn
bs-pt | bos_Latn-por_Latn
bs-ro | bos_Latn-ron_Latn
bs-ru | bos_Latn-rus_Cyrl
bs-si | bos_Latn-sin_Sinh
bs-sk | bos_Latn-slk_Latn
bs-sl | bos_Latn-slv_Latn
bs-sq | bos_Latn-sqi_Latn
bs-sr | bos_Latn-srp_Cyrl
bs-sv | bos_Latn-swe_Latn
bs-sw | bos_Latn-swa_Latn
bs-ta | bos_Latn-tam_Taml
bs-te | bos_Latn-tel_Telu
bs-tl | bos_Latn-tgl_Latn
bs-tr | bos_Latn-tur_Latn
bs-tt | bos_Latn-tat_Cyrl
bs-uk | bos_Latn-ukr_Cyrl
bs-ur | bos_Latn-urd_Arab
bs-uz | bos_Latn-uzb_Latn
bs-vi | bos_Latn-vie_Latn
bs-yue | bos_Latn-yue_Hant
bs-zh_CN | bos_Latn-zho_Hans
bs-zh_TW | bos_Latn-zho_Hant
bs-zh_ze | bos_Latn-zho_Hans
ca-ca | cat_Latn-cat_Latn
ca-cs | cat_Latn-ces_Latn
ca-da | cat_Latn-dan_Latn
ca-de | cat_Latn-deu_Latn
ca-el | cat_Latn-ell_Grek
ca-en | cat_Latn-eng_Latn
ca-es_419 | cat_Latn-spa_Latn
ca-es | cat_Latn-spa_Latn
ca-es_ES | cat_Latn-spa_Latn
ca-et | cat_Latn-est_Latn
ca-eu | cat_Latn-eus_Latn
ca-fa | cat_Latn-fas_Arab
ca-fi | cat_Latn-fin_Latn
ca-fr | cat_Latn-fra_Latn
ca-gl | cat_Latn-glg_Latn
ca-he | cat_Latn-heb_Hebr
ca-hi | cat_Latn-hin_Deva
ca-hr | cat_Latn-hrv_Latn
ca-hu | cat_Latn-hun_Latn
ca-id | cat_Latn-ind_Latn
ca-is | cat_Latn-isl_Latn
ca-it | cat_Latn-ita_Latn
ca-ka | cat_Latn-kat_Geor
ca-kn | cat_Latn-kan_Knda
ca-ko | cat_Latn-kor_Hang
ca-lt | cat_Latn-lit_Latn
ca-lv | cat_Latn-lav_Latn
ca-mk | cat_Latn-mkd_Cyrl
ca-ml | cat_Latn-mal_Mlym
ca-ms | cat_Latn-msa_Latn
ca-my | cat_Latn-mya_Mymr
ca-nl | cat_Latn-nld_Latn
ca-no | cat_Latn-nob_Latn
ca-pl | cat_Latn-pol_Latn
ca-pt_BR | cat_Latn-por_Latn
ca-pt | cat_Latn-por_Latn
ca-ro | cat_Latn-ron_Latn
ca-ru | cat_Latn-rus_Cyrl
ca-si | cat_Latn-sin_Sinh
ca-sk | cat_Latn-slk_Latn
ca-sl | cat_Latn-slv_Latn
ca-sq | cat_Latn-sqi_Latn
ca-sr | cat_Latn-srp_Cyrl
ca-sv | cat_Latn-swe_Latn
ca-ta | cat_Latn-tam_Taml
ca-te | cat_Latn-tel_Telu
ca-tl | cat_Latn-tgl_Latn
ca-tr | cat_Latn-tur_Latn
ca-uk | cat_Latn-ukr_Cyrl
ca-ur | cat_Latn-urd_Arab
ca-vi | cat_Latn-vie_Latn
ca-zh_CN | cat_Latn-zho_Hans
ca-zh_TW | cat_Latn-zho_Hant
cs-cs | ces_Latn-ces_Latn
cs-da | ces_Latn-dan_Latn
cs-de | ces_Latn-deu_Latn
cs-el | ces_Latn-ell_Grek
cs-en | ces_Latn-eng_Latn
cs-es_419 | ces_Latn-spa_Latn
cs-es | ces_Latn-spa_Latn
cs-es_ES | ces_Latn-spa_Latn
cs-et | ces_Latn-est_Latn
cs-eu | ces_Latn-eus_Latn
cs-fa | ces_Latn-fas_Arab
cs-fi | ces_Latn-fin_Latn
cs-fr | ces_Latn-fra_Latn
cs-gl | ces_Latn-glg_Latn
cs-he | ces_Latn-heb_Hebr
cs-hi | ces_Latn-hin_Deva
cs-hr | ces_Latn-hrv_Latn
cs-hu | ces_Latn-hun_Latn
cs-id | ces_Latn-ind_Latn
cs-is | ces_Latn-isl_Latn
cs-it | ces_Latn-ita_Latn
cs-ka | ces_Latn-kat_Geor
cs-kk | ces_Latn-kaz_Cyrl
cs-km | ces_Latn-khm_Khmr
cs-kn | ces_Latn-kan_Knda
cs-ko | ces_Latn-kor_Hang
cs-ku | ces_Latn-kmr_Latn
cs-lt | ces_Latn-lit_Latn
cs-lv | ces_Latn-lav_Latn
cs-mk | ces_Latn-mkd_Cyrl
cs-ml | ces_Latn-mal_Mlym
cs-mn | ces_Latn-mon_Cyrl
cs-ms | ces_Latn-msa_Latn
cs-my | ces_Latn-mya_Mymr
cs-nl | ces_Latn-nld_Latn
cs-no | ces_Latn-nob_Latn
cs-pl | ces_Latn-pol_Latn
cs-pt_BR | ces_Latn-por_Latn
cs-pt | ces_Latn-por_Latn
cs-ro | ces_Latn-ron_Latn
cs-ru | ces_Latn-rus_Cyrl
cs-si | ces_Latn-sin_Sinh
cs-sk | ces_Latn-slk_Latn
cs-sl | ces_Latn-slv_Latn
cs-sq | ces_Latn-sqi_Latn
cs-sr | ces_Latn-srp_Cyrl
cs-sv | ces_Latn-swe_Latn
cs-sw | ces_Latn-swa_Latn
cs-ta | ces_Latn-tam_Taml
cs-te | ces_Latn-tel_Telu
cs-tl | ces_Latn-tgl_Latn
cs-tr | ces_Latn-tur_Latn
cs-tt | ces_Latn-tat_Cyrl
cs-uk | ces_Latn-ukr_Cyrl
cs-ur | ces_Latn-urd_Arab
cs-uz | ces_Latn-uzb_Latn
cs-vi | ces_Latn-vie_Latn
cs-yue | ces_Latn-yue_Hant
cs-zh_CN | ces_Latn-zho_Hans
cs-zh_TW | ces_Latn-zho_Hant
cs-zh_ze | ces_Latn-zho_Hans
da-da | dan_Latn-dan_Latn
da-de | dan_Latn-deu_Latn
da-el | dan_Latn-ell_Grek
da-en | dan_Latn-eng_Latn
da-en_ze | dan_Latn-eng_Latn
da-es_419 | dan_Latn-spa_Latn
da-es | dan_Latn-spa_Latn
da-es_ES | dan_Latn-spa_Latn
da-et | dan_Latn-est_Latn
da-eu | dan_Latn-eus_Latn
da-fa | dan_Latn-fas_Arab
da-fi | dan_Latn-fin_Latn
da-fr | dan_Latn-fra_Latn
da-gl | dan_Latn-glg_Latn
da-he | dan_Latn-heb_Hebr
da-hi | dan_Latn-hin_Deva
da-hr | dan_Latn-hrv_Latn
da-hu | dan_Latn-hun_Latn
da-hy | dan_Latn-hye_Armn
da-id | dan_Latn-ind_Latn
da-is | dan_Latn-isl_Latn
da-it | dan_Latn-ita_Latn
da-ka | dan_Latn-kat_Geor
da-kk | dan_Latn-kaz_Cyrl
da-km | dan_Latn-khm_Khmr
da-kn | dan_Latn-kan_Knda
da-ko | dan_Latn-kor_Hang
da-ku | dan_Latn-kmr_Latn
da-lt | dan_Latn-lit_Latn
da-lv | dan_Latn-lav_Latn
da-mk | dan_Latn-mkd_Cyrl
da-ml | dan_Latn-mal_Mlym
da-mn | dan_Latn-mon_Cyrl
da-ms | dan_Latn-msa_Latn
da-my | dan_Latn-mya_Mymr
da-nl | dan_Latn-nld_Latn
da-no | dan_Latn-nob_Latn
da-pl | dan_Latn-pol_Latn
da-pt_BR | dan_Latn-por_Latn
da-pt | dan_Latn-por_Latn
da-pt_MZ | dan_Latn-por_Latn
da-ro | dan_Latn-ron_Latn
da-ru | dan_Latn-rus_Cyrl
da-si | dan_Latn-sin_Sinh
da-sk | dan_Latn-slk_Latn
da-sl | dan_Latn-slv_Latn
da-sq | dan_Latn-sqi_Latn
da-sr | dan_Latn-srp_Cyrl
da-sv | dan_Latn-swe_Latn
da-sw | dan_Latn-swa_Latn
da-ta | dan_Latn-tam_Taml
da-te | dan_Latn-tel_Telu
da-tl | dan_Latn-tgl_Latn
da-tr | dan_Latn-tur_Latn
da-tt | dan_Latn-tat_Cyrl
da-uk | dan_Latn-ukr_Cyrl
da-ur | dan_Latn-urd_Arab
da-uz | dan_Latn-uzb_Latn
da-vi | dan_Latn-vie_Latn
da-yue | dan_Latn-yue_Hant
da-zh_CN | dan_Latn-zho_Hans
da-zh_TW | dan_Latn-zho_Hant
da-zh_ze | dan_Latn-zho_Hans
de-de | deu_Latn-deu_Latn
de-el | deu_Latn-ell_Grek
de-en | deu_Latn-eng_Latn
de-en_ze | deu_Latn-eng_Latn
de-es_419 | deu_Latn-spa_Latn
de-es | deu_Latn-spa_Latn
de-es_ES | deu_Latn-spa_Latn
de-et | deu_Latn-est_Latn
de-eu | deu_Latn-eus_Latn
de-fa | deu_Latn-fas_Arab
de-fi | deu_Latn-fin_Latn
de-fr | deu_Latn-fra_Latn
de-gl | deu_Latn-glg_Latn
de-he | deu_Latn-heb_Hebr
de-hi | deu_Latn-hin_Deva
de-hr | deu_Latn-hrv_Latn
de-hu | deu_Latn-hun_Latn
de-id | deu_Latn-ind_Latn
de-is | deu_Latn-isl_Latn
de-it | deu_Latn-ita_Latn
de-ka | deu_Latn-kat_Geor
de-kk | deu_Latn-kaz_Cyrl
de-km | deu_Latn-khm_Khmr
de-kn | deu_Latn-kan_Knda
de-ko | deu_Latn-kor_Hang
de-ku | deu_Latn-kmr_Latn
de-lt | deu_Latn-lit_Latn
de-lv | deu_Latn-lav_Latn
de-mk | deu_Latn-mkd_Cyrl
de-ml | deu_Latn-mal_Mlym
de-mn | deu_Latn-mon_Cyrl
de-ms | deu_Latn-msa_Latn
de-my | deu_Latn-mya_Mymr
de-nl | deu_Latn-nld_Latn
de-no | deu_Latn-nob_Latn
de-pl | deu_Latn-pol_Latn
de-pt_BR | deu_Latn-por_Latn
de-pt | deu_Latn-por_Latn
de-pt_MZ | deu_Latn-por_Latn
de-ro | deu_Latn-ron_Latn
de-ru | deu_Latn-rus_Cyrl
de-si | deu_Latn-sin_Sinh
de-sk | deu_Latn-slk_Latn
de-sl | deu_Latn-slv_Latn
de-sq | deu_Latn-sqi_Latn
de-sr | deu_Latn-srp_Cyrl
de-sv | deu_Latn-swe_Latn
de-sw | deu_Latn-swa_Latn
de-ta | deu_Latn-tam_Taml
de-te | deu_Latn-tel_Telu
de-tl | deu_Latn-tgl_Latn
de-tr | deu_Latn-tur_Latn
de-tt | deu_Latn-tat_Cyrl
de-uk | deu_Latn-ukr_Cyrl
de-ur | deu_Latn-urd_Arab
de-uz | deu_Latn-uzb_Latn
de-vi | deu_Latn-vie_Latn
de-yue | deu_Latn-yue_Hant
de-zh_CN | deu_Latn-zho_Hans
de-zh_TW | deu_Latn-zho_Hant
de-zh_ze | deu_Latn-zho_Hans
el-el | ell_Grek-ell_Grek
el-en | ell_Grek-eng_Latn
el-es_419 | ell_Grek-spa_Latn
el-es | ell_Grek-spa_Latn
el-es_ES | ell_Grek-spa_Latn
el-et | ell_Grek-est_Latn
el-eu | ell_Grek-eus_Latn
el-fa | ell_Grek-fas_Arab
el-fi | ell_Grek-fin_Latn
el-fr | ell_Grek-fra_Latn
el-gl | ell_Grek-glg_Latn
el-he | ell_Grek-heb_Hebr
el-hi | ell_Grek-hin_Deva
el-hr | ell_Grek-hrv_Latn
el-hu | ell_Grek-hun_Latn
el-id | ell_Grek-ind_Latn
el-is | ell_Grek-isl_Latn
el-it | ell_Grek-ita_Latn
el-ka | ell_Grek-kat_Geor
el-kk | ell_Grek-kaz_Cyrl
el-km | ell_Grek-khm_Khmr
el-kn | ell_Grek-kan_Knda
el-ko | ell_Grek-kor_Hang
el-ku | ell_Grek-kmr_Latn
el-lt | ell_Grek-lit_Latn
el-lv | ell_Grek-lav_Latn
el-mk | ell_Grek-mkd_Cyrl
el-ml | ell_Grek-mal_Mlym
el-mn | ell_Grek-mon_Cyrl
el-ms | ell_Grek-msa_Latn
el-my | ell_Grek-mya_Mymr
el-nl | ell_Grek-nld_Latn
el-no | ell_Grek-nob_Latn
el-pl | ell_Grek-pol_Latn
el-ps | ell_Grek-pus_Arab
el-pt | ell_Grek-por_Latn
el-ro | ell_Grek-ron_Latn
el-ru | ell_Grek-rus_Cyrl
el-si | ell_Grek-sin_Sinh
el-sk | ell_Grek-slk_Latn
el-sl | ell_Grek-slv_Latn
el-sq | ell_Grek-sqi_Latn
el-sr | ell_Grek-srp_Cyrl
el-sv | ell_Grek-swe_Latn
el-sw | ell_Grek-swa_Latn
el-ta | ell_Grek-tam_Taml
el-te | ell_Grek-tel_Telu
el-tl | ell_Grek-tgl_Latn
el-tr | ell_Grek-tur_Latn
el-tt | ell_Grek-tat_Cyrl
el-uk | ell_Grek-ukr_Cyrl
el-ur | ell_Grek-urd_Arab
el-uz | ell_Grek-uzb_Latn
el-vi | ell_Grek-vie_Latn
el-yue | ell_Grek-yue_Hant
el-zh_CN | ell_Grek-zho_Hans
el-zh_TW | ell_Grek-zho_Hant
el-zh_ze | ell_Grek-zho_Hans
en-en_ze | eng_Latn-eng_Latn
en-es_419 | eng_Latn-spa_Latn
en-es | eng_Latn-spa_Latn
en-es_ES | eng_Latn-spa_Latn
en-et | eng_Latn-est_Latn
en-eu | eng_Latn-eus_Latn
en-fa | eng_Latn-fas_Arab
en-fi | eng_Latn-fin_Latn
en-fr | eng_Latn-fra_Latn
en-gl | eng_Latn-glg_Latn
en-he | eng_Latn-heb_Hebr
en-hi | eng_Latn-hin_Deva
en-hr | eng_Latn-hrv_Latn
en-hu | eng_Latn-hun_Latn
en-id | eng_Latn-ind_Latn
en-is | eng_Latn-isl_Latn
en-it | eng_Latn-ita_Latn
en-ka | eng_Latn-kat_Geor
en-kk | eng_Latn-kaz_Cyrl
en-km | eng_Latn-khm_Khmr
en-kn | eng_Latn-kan_Knda
en-ko | eng_Latn-kor_Hang
en-ku | eng_Latn-kmr_Latn
en-lt | eng_Latn-lit_Latn
en-lv | eng_Latn-lav_Latn
en-mk | eng_Latn-mkd_Cyrl
en-ml | eng_Latn-mal_Mlym
en-mn | eng_Latn-mon_Cyrl
en-ms | eng_Latn-msa_Latn
en-my | eng_Latn-mya_Mymr
en-nl | eng_Latn-nld_Latn
en-no | eng_Latn-nob_Latn
en-pl | eng_Latn-pol_Latn
en-ps | eng_Latn-pus_Arab
en-pt_BR | eng_Latn-por_Latn
en-pt | eng_Latn-por_Latn
en-pt_MZ | eng_Latn-por_Latn
en-ro | eng_Latn-ron_Latn
en-ru | eng_Latn-rus_Cyrl
en-si | eng_Latn-sin_Sinh
en-sk | eng_Latn-slk_Latn
en-sl | eng_Latn-slv_Latn
en-sq | eng_Latn-sqi_Latn
en-sr | eng_Latn-srp_Cyrl
en-sv | eng_Latn-swe_Latn
en-sw | eng_Latn-swa_Latn
en-ta | eng_Latn-tam_Taml
en-te | eng_Latn-tel_Telu
en-tl | eng_Latn-tgl_Latn
en-tr | eng_Latn-tur_Latn
en-tt | eng_Latn-tat_Cyrl
en-uk | eng_Latn-ukr_Cyrl
en-ur | eng_Latn-urd_Arab
en-uz | eng_Latn-uzb_Latn
en-vi | eng_Latn-vie_Latn
en-yue | eng_Latn-yue_Hant
en-zh_CN | eng_Latn-zho_Hans
en-zh_TW | eng_Latn-zho_Hant
en-zh_ze | eng_Latn-zho_Hans
es_419-es_ES | spa_Latn-spa_Latn
es_419-et | spa_Latn-est_Latn
es_419-eu | spa_Latn-eus_Latn
es_419-fa | spa_Latn-fas_Arab
es_419-fi | spa_Latn-fin_Latn
es_419-fr | spa_Latn-fra_Latn
es_419-gl | spa_Latn-glg_Latn
es_419-he | spa_Latn-heb_Hebr
es_419-hi | spa_Latn-hin_Deva
es_419-hr | spa_Latn-hrv_Latn
es_419-hu | spa_Latn-hun_Latn
es_419-id | spa_Latn-ind_Latn
es_419-is | spa_Latn-isl_Latn
es_419-it | spa_Latn-ita_Latn
es_419-ka | spa_Latn-kat_Geor
es_419-kk | spa_Latn-kaz_Cyrl
es_419-km | spa_Latn-khm_Khmr
es_419-kn | spa_Latn-kan_Knda
es_419-ko | spa_Latn-kor_Hang
es_419-ku | spa_Latn-kmr_Latn
es_419-lt | spa_Latn-lit_Latn
es_419-lv | spa_Latn-lav_Latn
es_419-mk | spa_Latn-mkd_Cyrl
es_419-ml | spa_Latn-mal_Mlym
es_419-mn | spa_Latn-mon_Cyrl
es_419-ms | spa_Latn-msa_Latn
es_419-my | spa_Latn-mya_Mymr
es_419-nl | spa_Latn-nld_Latn
es_419-no | spa_Latn-nob_Latn
es_419-pl | spa_Latn-pol_Latn
es_419-ps | spa_Latn-pus_Arab
es_419-pt_BR | spa_Latn-por_Latn
es_419-pt | spa_Latn-por_Latn
es_419-pt_MZ | spa_Latn-por_Latn
es_419-ro | spa_Latn-ron_Latn
es_419-ru | spa_Latn-rus_Cyrl
es_419-si | spa_Latn-sin_Sinh
es_419-sk | spa_Latn-slk_Latn
es_419-sl | spa_Latn-slv_Latn
es_419-sq | spa_Latn-sqi_Latn
es_419-sr | spa_Latn-srp_Cyrl
es_419-sv | spa_Latn-swe_Latn
es_419-sw | spa_Latn-swa_Latn
es_419-ta | spa_Latn-tam_Taml
es_419-te | spa_Latn-tel_Telu
es_419-tl | spa_Latn-tgl_Latn
es_419-tr | spa_Latn-tur_Latn
es_419-tt | spa_Latn-tat_Cyrl
es_419-uk | spa_Latn-ukr_Cyrl
es_419-ur | spa_Latn-urd_Arab
es_419-uz | spa_Latn-uzb_Latn
es_419-vi | spa_Latn-vie_Latn
es_419-yue | spa_Latn-yue_Hant
es_419-zh_CN | spa_Latn-zho_Hans
es_419-zh_TW | spa_Latn-zho_Hant
es_419-zh_ze | spa_Latn-zho_Hans
es-es_ES | spa_Latn-spa_Latn
es-et | spa_Latn-est_Latn
es-eu | spa_Latn-eus_Latn
es-fa | spa_Latn-fas_Arab
es-fi | spa_Latn-fin_Latn
es-fr | spa_Latn-fra_Latn
es-gl | spa_Latn-glg_Latn
es-he | spa_Latn-heb_Hebr
es-hi | spa_Latn-hin_Deva
es-hr | spa_Latn-hrv_Latn
es-hu | spa_Latn-hun_Latn
es-hy | spa_Latn-hye_Armn
es-id | spa_Latn-ind_Latn
es-is | spa_Latn-isl_Latn
es-it | spa_Latn-ita_Latn
es-ka | spa_Latn-kat_Geor
es-kk | spa_Latn-kaz_Cyrl
es-km | spa_Latn-khm_Khmr
es-kn | spa_Latn-kan_Knda
es-ko | spa_Latn-kor_Hang
es-ku | spa_Latn-kmr_Latn
es-lt | spa_Latn-lit_Latn
es-lv | spa_Latn-lav_Latn
es-mk | spa_Latn-mkd_Cyrl
es-ml | spa_Latn-mal_Mlym
es-mn | spa_Latn-mon_Cyrl
es-ms | spa_Latn-msa_Latn
es-my | spa_Latn-mya_Mymr
es-nl | spa_Latn-nld_Latn
es-no | spa_Latn-nob_Latn
es-pl | spa_Latn-pol_Latn
es-ps | spa_Latn-pus_Arab
es-pt_BR | spa_Latn-por_Latn
es-pt | spa_Latn-por_Latn
es-pt_MZ | spa_Latn-por_Latn
es-ro | spa_Latn-ron_Latn
es-ru | spa_Latn-rus_Cyrl
es-si | spa_Latn-sin_Sinh
es-sk | spa_Latn-slk_Latn
es-sl | spa_Latn-slv_Latn
es-sq | spa_Latn-sqi_Latn
es-sr | spa_Latn-srp_Cyrl
es-sv | spa_Latn-swe_Latn
es-sw | spa_Latn-swa_Latn
es-ta | spa_Latn-tam_Taml
es-te | spa_Latn-tel_Telu
es-tl | spa_Latn-tgl_Latn
es-tr | spa_Latn-tur_Latn
es-tt | spa_Latn-tat_Cyrl
es-uk | spa_Latn-ukr_Cyrl
es-ur | spa_Latn-urd_Arab
es-uz | spa_Latn-uzb_Latn
es-vi | spa_Latn-vie_Latn
es-yue | spa_Latn-yue_Hant
es-zh_CN | spa_Latn-zho_Hans
es-zh_TW | spa_Latn-zho_Hant
es-zh_ze | spa_Latn-zho_Hans
es_ES-et | spa_Latn-est_Latn
es_ES-eu | spa_Latn-eus_Latn
es_ES-fa | spa_Latn-fas_Arab
es_ES-fi | spa_Latn-fin_Latn
es_ES-fr | spa_Latn-fra_Latn
es_ES-gl | spa_Latn-glg_Latn
es_ES-he | spa_Latn-heb_Hebr
es_ES-hi | spa_Latn-hin_Deva
es_ES-hr | spa_Latn-hrv_Latn
es_ES-hu | spa_Latn-hun_Latn
es_ES-id | spa_Latn-ind_Latn
es_ES-is | spa_Latn-isl_Latn
es_ES-it | spa_Latn-ita_Latn
es_ES-ka | spa_Latn-kat_Geor
es_ES-kk | spa_Latn-kaz_Cyrl
es_ES-km | spa_Latn-khm_Khmr
es_ES-kn | spa_Latn-kan_Knda
es_ES-ko | spa_Latn-kor_Hang
es_ES-ku | spa_Latn-kmr_Latn
es_ES-lt | spa_Latn-lit_Latn
es_ES-lv | spa_Latn-lav_Latn
es_ES-mk | spa_Latn-mkd_Cyrl
es_ES-ml | spa_Latn-mal_Mlym
es_ES-mn | spa_Latn-mon_Cyrl
es_ES-ms | spa_Latn-msa_Latn
es_ES-my | spa_Latn-mya_Mymr
es_ES-nl | spa_Latn-nld_Latn
es_ES-no | spa_Latn-nob_Latn
es_ES-pl | spa_Latn-pol_Latn
es_ES-pt_BR | spa_Latn-por_Latn
es_ES-pt | spa_Latn-por_Latn
es_ES-pt_MZ | spa_Latn-por_Latn
es_ES-ro | spa_Latn-ron_Latn
es_ES-ru | spa_Latn-rus_Cyrl
es_ES-si | spa_Latn-sin_Sinh
es_ES-sk | spa_Latn-slk_Latn
es_ES-sl | spa_Latn-slv_Latn
es_ES-sq | spa_Latn-sqi_Latn
es_ES-sr | spa_Latn-srp_Cyrl
es_ES-sv | spa_Latn-swe_Latn
es_ES-sw | spa_Latn-swa_Latn
es_ES-ta | spa_Latn-tam_Taml
es_ES-te | spa_Latn-tel_Telu
es_ES-tl | spa_Latn-tgl_Latn
es_ES-tr | spa_Latn-tur_Latn
es_ES-tt | spa_Latn-tat_Cyrl
es_ES-uk | spa_Latn-ukr_Cyrl
es_ES-ur | spa_Latn-urd_Arab
es_ES-uz | spa_Latn-uzb_Latn
es_ES-vi | spa_Latn-vie_Latn
es_ES-yue | spa_Latn-yue_Hant
es_ES-zh_CN | spa_Latn-zho_Hans
es_ES-zh_TW | spa_Latn-zho_Hant
es_ES-zh_ze | spa_Latn-zho_Hans
et-eu | est_Latn-eus_Latn
et-fa | est_Latn-fas_Arab
et-fi | est_Latn-fin_Latn
et-fr | est_Latn-fra_Latn
et-gl | est_Latn-glg_Latn
et-he | est_Latn-heb_Hebr
et-hi | est_Latn-hin_Deva
et-hr | est_Latn-hrv_Latn
et-hu | est_Latn-hun_Latn
et-id | est_Latn-ind_Latn
et-is | est_Latn-isl_Latn
et-it | est_Latn-ita_Latn
et-ka | est_Latn-kat_Geor
et-kk | est_Latn-kaz_Cyrl
et-km | est_Latn-khm_Khmr
et-kn | est_Latn-kan_Knda
et-ko | est_Latn-kor_Hang
et-ku | est_Latn-kmr_Latn
et-lt | est_Latn-lit_Latn
et-lv | est_Latn-lav_Latn
et-mk | est_Latn-mkd_Cyrl
et-ml | est_Latn-mal_Mlym
et-mn | est_Latn-mon_Cyrl
et-ms | est_Latn-msa_Latn
et-my | est_Latn-mya_Mymr
et-nl | est_Latn-nld_Latn
et-no | est_Latn-nob_Latn
et-pl | est_Latn-pol_Latn
et-pt_BR | est_Latn-por_Latn
et-pt | est_Latn-por_Latn
et-pt_MZ | est_Latn-por_Latn
et-ro | est_Latn-ron_Latn
et-ru | est_Latn-rus_Cyrl
et-si | est_Latn-sin_Sinh
et-sk | est_Latn-slk_Latn
et-sl | est_Latn-slv_Latn
et-sq | est_Latn-sqi_Latn
et-sr | est_Latn-srp_Cyrl
et-sv | est_Latn-swe_Latn
et-sw | est_Latn-swa_Latn
et-ta | est_Latn-tam_Taml
et-te | est_Latn-tel_Telu
et-tl | est_Latn-tgl_Latn
et-tr | est_Latn-tur_Latn
et-tt | est_Latn-tat_Cyrl
et-uk | est_Latn-ukr_Cyrl
et-ur | est_Latn-urd_Arab
et-uz | est_Latn-uzb_Latn
et-vi | est_Latn-vie_Latn
et-yue | est_Latn-yue_Hant
et-zh_CN | est_Latn-zho_Hans
et-zh_TW | est_Latn-zho_Hant
et-zh_ze | est_Latn-zho_Hans
eu-fa | eus_Latn-fas_Arab
eu-fi | eus_Latn-fin_Latn
eu-fr | eus_Latn-fra_Latn
eu-gl | eus_Latn-glg_Latn
eu-he | eus_Latn-heb_Hebr
eu-hi | eus_Latn-hin_Deva
eu-hr | eus_Latn-hrv_Latn
eu-hu | eus_Latn-hun_Latn
eu-id | eus_Latn-ind_Latn
eu-is | eus_Latn-isl_Latn
eu-it | eus_Latn-ita_Latn
eu-kn | eus_Latn-kan_Knda
eu-ko | eus_Latn-kor_Hang
eu-lv | eus_Latn-lav_Latn
eu-mk | eus_Latn-mkd_Cyrl
eu-ml | eus_Latn-mal_Mlym
eu-ms | eus_Latn-msa_Latn
eu-my | eus_Latn-mya_Mymr
eu-nl | eus_Latn-nld_Latn
eu-no | eus_Latn-nob_Latn
eu-pl | eus_Latn-pol_Latn
eu-pt_BR | eus_Latn-por_Latn
eu-pt | eus_Latn-por_Latn
eu-ro | eus_Latn-ron_Latn
eu-ru | eus_Latn-rus_Cyrl
eu-si | eus_Latn-sin_Sinh
eu-sk | eus_Latn-slk_Latn
eu-sl | eus_Latn-slv_Latn
eu-sq | eus_Latn-sqi_Latn
eu-sr | eus_Latn-srp_Cyrl
eu-sv | eus_Latn-swe_Latn
eu-ta | eus_Latn-tam_Taml
eu-te | eus_Latn-tel_Telu
eu-tl | eus_Latn-tgl_Latn
eu-tr | eus_Latn-tur_Latn
eu-uk | eus_Latn-ukr_Cyrl
eu-ur | eus_Latn-urd_Arab
eu-vi | eus_Latn-vie_Latn
eu-yue | eus_Latn-yue_Hant
eu-zh_CN | eus_Latn-zho_Hans
eu-zh_TW | eus_Latn-zho_Hant
eu-zh_ze | eus_Latn-zho_Hans
fi-fr | fin_Latn-fra_Latn
fi-gl | fin_Latn-glg_Latn
fi-he | fin_Latn-heb_Hebr
fi-hi | fin_Latn-hin_Deva
fi-hr | fin_Latn-hrv_Latn
fi-hu | fin_Latn-hun_Latn
fi-hy | fin_Latn-hye_Armn
fi-id | fin_Latn-ind_Latn
fi-is | fin_Latn-isl_Latn
fi-it | fin_Latn-ita_Latn
fi-ka | fin_Latn-kat_Geor
fi-kk | fin_Latn-kaz_Cyrl
fi-km | fin_Latn-khm_Khmr
fi-kn | fin_Latn-kan_Knda
fi-ko | fin_Latn-kor_Hang
fi-ku | fin_Latn-kmr_Latn
fi-lt | fin_Latn-lit_Latn
fi-lv | fin_Latn-lav_Latn
fi-mk | fin_Latn-mkd_Cyrl
fi-ml | fin_Latn-mal_Mlym
fi-mn | fin_Latn-mon_Cyrl
fi-ms | fin_Latn-msa_Latn
fi-my | fin_Latn-mya_Mymr
fi-nl | fin_Latn-nld_Latn
fi-no | fin_Latn-nob_Latn
fi-pl | fin_Latn-pol_Latn
fi-pt_BR | fin_Latn-por_Latn
fi-pt | fin_Latn-por_Latn
fi-ro | fin_Latn-ron_Latn
fi-ru | fin_Latn-rus_Cyrl
fi-si | fin_Latn-sin_Sinh
fi-sk | fin_Latn-slk_Latn
fi-sl | fin_Latn-slv_Latn
fi-sq | fin_Latn-sqi_Latn
fi-sr | fin_Latn-srp_Cyrl
fi-sv | fin_Latn-swe_Latn
fi-sw | fin_Latn-swa_Latn
fi-ta | fin_Latn-tam_Taml
fi-te | fin_Latn-tel_Telu
fi-tl | fin_Latn-tgl_Latn
fi-tr | fin_Latn-tur_Latn
fi-tt | fin_Latn-tat_Cyrl
fi-uk | fin_Latn-ukr_Cyrl
fi-ur | fin_Latn-urd_Arab
fi-uz | fin_Latn-uzb_Latn
fi-vi | fin_Latn-vie_Latn
fi-yue | fin_Latn-yue_Hant
fi-zh_CN | fin_Latn-zho_Hans
fi-zh_TW | fin_Latn-zho_Hant
fi-zh_ze | fin_Latn-zho_Hans
fr-gl | fra_Latn-glg_Latn
fr-he | fra_Latn-heb_Hebr
fr-hi | fra_Latn-hin_Deva
fr-hr | fra_Latn-hrv_Latn
fr-hu | fra_Latn-hun_Latn
fr-hy | fra_Latn-hye_Armn
fr-id | fra_Latn-ind_Latn
fr-is | fra_Latn-isl_Latn
fr-it | fra_Latn-ita_Latn
fr-ka | fra_Latn-kat_Geor
fr-kk | fra_Latn-kaz_Cyrl
fr-km | fra_Latn-khm_Khmr
fr-kn | fra_Latn-kan_Knda
fr-ko | fra_Latn-kor_Hang
fr-ku | fra_Latn-kmr_Latn
fr-lt | fra_Latn-lit_Latn
fr-lv | fra_Latn-lav_Latn
fr-mk | fra_Latn-mkd_Cyrl
fr-ml | fra_Latn-mal_Mlym
fr-mn | fra_Latn-mon_Cyrl
fr-ms | fra_Latn-msa_Latn
fr-my | fra_Latn-mya_Mymr
fr-nl | fra_Latn-nld_Latn
fr-no | fra_Latn-nob_Latn
fr-pl | fra_Latn-pol_Latn
fr-ps | fra_Latn-pus_Arab
fr-pt_BR | fra_Latn-por_Latn
fr-pt | fra_Latn-por_Latn
fr-pt_MZ | fra_Latn-por_Latn
fr-ro | fra_Latn-ron_Latn
fr-ru | fra_Latn-rus_Cyrl
fr-si | fra_Latn-sin_Sinh
fr-sk | fra_Latn-slk_Latn
fr-sl | fra_Latn-slv_Latn
fr-sq | fra_Latn-sqi_Latn
fr-sr | fra_Latn-srp_Cyrl
fr-sv | fra_Latn-swe_Latn
fr-sw | fra_Latn-swa_Latn
fr-ta | fra_Latn-tam_Taml
fr-te | fra_Latn-tel_Telu
fr-tl | fra_Latn-tgl_Latn
fr-tr | fra_Latn-tur_Latn
fr-tt | fra_Latn-tat_Cyrl
fr-uk | fra_Latn-ukr_Cyrl
fr-ur | fra_Latn-urd_Arab
fr-uz | fra_Latn-uzb_Latn
fr-vi | fra_Latn-vie_Latn
fr-yue | fra_Latn-yue_Hant
fr-zh_CN | fra_Latn-zho_Hans
fr-zh_TW | fra_Latn-zho_Hant
fr-zh_ze | fra_Latn-zho_Hans
gl-he | glg_Latn-heb_Hebr
gl-hi | glg_Latn-hin_Deva
gl-hr | glg_Latn-hrv_Latn
gl-hu | glg_Latn-hun_Latn
gl-id | glg_Latn-ind_Latn
gl-is | glg_Latn-isl_Latn
gl-it | glg_Latn-ita_Latn
gl-kn | glg_Latn-kan_Knda
gl-ko | glg_Latn-kor_Hang
gl-lv | glg_Latn-lav_Latn
gl-mk | glg_Latn-mkd_Cyrl
gl-ml | glg_Latn-mal_Mlym
gl-ms | glg_Latn-msa_Latn
gl-my | glg_Latn-mya_Mymr
gl-nl | glg_Latn-nld_Latn
gl-no | glg_Latn-nob_Latn
gl-pl | glg_Latn-pol_Latn
gl-pt_BR | glg_Latn-por_Latn
gl-pt | glg_Latn-por_Latn
gl-ro | glg_Latn-ron_Latn
gl-ru | glg_Latn-rus_Cyrl
gl-si | glg_Latn-sin_Sinh
gl-sk | glg_Latn-slk_Latn
gl-sl | glg_Latn-slv_Latn
gl-sq | glg_Latn-sqi_Latn
gl-sr | glg_Latn-srp_Cyrl
gl-sv | glg_Latn-swe_Latn
gl-ta | glg_Latn-tam_Taml
gl-te | glg_Latn-tel_Telu
gl-tl | glg_Latn-tgl_Latn
gl-tr | glg_Latn-tur_Latn
gl-uk | glg_Latn-ukr_Cyrl
gl-ur | glg_Latn-urd_Arab
gl-vi | glg_Latn-vie_Latn
gl-zh_CN | glg_Latn-zho_Hans
gl-zh_TW | glg_Latn-zho_Hant
he-hi | heb_Hebr-hin_Deva
he-hr | heb_Hebr-hrv_Latn
he-hu | heb_Hebr-hun_Latn
he-id | heb_Hebr-ind_Latn
he-is | heb_Hebr-isl_Latn
he-it | heb_Hebr-ita_Latn
he-ka | heb_Hebr-kat_Geor
he-kk | heb_Hebr-kaz_Cyrl
he-km | heb_Hebr-khm_Khmr
he-kn | heb_Hebr-kan_Knda
he-ko | heb_Hebr-kor_Hang
he-ku | heb_Hebr-kmr_Latn
he-lt | heb_Hebr-lit_Latn
he-lv | heb_Hebr-lav_Latn
he-mk | heb_Hebr-mkd_Cyrl
he-ml | heb_Hebr-mal_Mlym
he-mn | heb_Hebr-mon_Cyrl
he-ms | heb_Hebr-msa_Latn
he-my | heb_Hebr-mya_Mymr
he-nl | heb_Hebr-nld_Latn
he-no | heb_Hebr-nob_Latn
he-pl | heb_Hebr-pol_Latn
he-pt_BR | heb_Hebr-por_Latn
he-pt | heb_Hebr-por_Latn
he-ro | heb_Hebr-ron_Latn
he-ru | heb_Hebr-rus_Cyrl
he-si | heb_Hebr-sin_Sinh
he-sk | heb_Hebr-slk_Latn
he-sl | heb_Hebr-slv_Latn
he-sq | heb_Hebr-sqi_Latn
he-sr | heb_Hebr-srp_Cyrl
he-sv | heb_Hebr-swe_Latn
he-sw | heb_Hebr-swa_Latn
he-ta | heb_Hebr-tam_Taml
he-te | heb_Hebr-tel_Telu
he-tl | heb_Hebr-tgl_Latn
he-tr | heb_Hebr-tur_Latn
he-tt | heb_Hebr-tat_Cyrl
he-uk | heb_Hebr-ukr_Cyrl
he-ur | heb_Hebr-urd_Arab
he-vi | heb_Hebr-vie_Latn
he-yue | heb_Hebr-yue_Hant
he-zh_CN | heb_Hebr-zho_Hans
he-zh_TW | heb_Hebr-zho_Hant
he-zh_ze | heb_Hebr-zho_Hans
hi-hr | hin_Deva-hrv_Latn
hi-hu | hin_Deva-hun_Latn
hi-id | hin_Deva-ind_Latn
hi-is | hin_Deva-isl_Latn
hi-it | hin_Deva-ita_Latn
hi-kn | hin_Deva-kan_Knda
hi-ko | hin_Deva-kor_Hang
hi-ku | hin_Deva-kmr_Latn
hi-lt | hin_Deva-lit_Latn
hi-lv | hin_Deva-lav_Latn
hi-mk | hin_Deva-mkd_Cyrl
hi-ml | hin_Deva-mal_Mlym
hi-ms | hin_Deva-msa_Latn
hi-my | hin_Deva-mya_Mymr
hi-nl | hin_Deva-nld_Latn
hi-no | hin_Deva-nob_Latn
hi-pl | hin_Deva-pol_Latn
hi-pt_BR | hin_Deva-por_Latn
hi-pt | hin_Deva-por_Latn
hi-ro | hin_Deva-ron_Latn
hi-ru | hin_Deva-rus_Cyrl
hi-si | hin_Deva-sin_Sinh
hi-sk | hin_Deva-slk_Latn
hi-sl | hin_Deva-slv_Latn
hi-sq | hin_Deva-sqi_Latn
hi-sr | hin_Deva-srp_Cyrl
hi-sv | hin_Deva-swe_Latn
hi-sw | hin_Deva-swa_Latn
hi-ta | hin_Deva-tam_Taml
hi-te | hin_Deva-tel_Telu
hi-tl | hin_Deva-tgl_Latn
hi-tr | hin_Deva-tur_Latn
hi-uk | hin_Deva-ukr_Cyrl
hi-ur | hin_Deva-urd_Arab
hi-vi | hin_Deva-vie_Latn
hi-yue | hin_Deva-yue_Hant
hi-zh_CN | hin_Deva-zho_Hans
hi-zh_TW | hin_Deva-zho_Hant
hi-zh_ze | hin_Deva-zho_Hans
hr-hu | hrv_Latn-hun_Latn
hr-id | hrv_Latn-ind_Latn
hr-is | hrv_Latn-isl_Latn
hr-it | hrv_Latn-ita_Latn
hr-ka | hrv_Latn-kat_Geor
hr-kk | hrv_Latn-kaz_Cyrl
hr-km | hrv_Latn-khm_Khmr
hr-kn | hrv_Latn-kan_Knda
hr-ko | hrv_Latn-kor_Hang
hr-ku | hrv_Latn-kmr_Latn
hr-lt | hrv_Latn-lit_Latn
hr-lv | hrv_Latn-lav_Latn
hr-mk | hrv_Latn-mkd_Cyrl
hr-ml | hrv_Latn-mal_Mlym
hr-mn | hrv_Latn-mon_Cyrl
hr-ms | hrv_Latn-msa_Latn
hr-my | hrv_Latn-mya_Mymr
hr-nl | hrv_Latn-nld_Latn
hr-no | hrv_Latn-nob_Latn
hr-pl | hrv_Latn-pol_Latn
hr-pt_BR | hrv_Latn-por_Latn
hr-pt | hrv_Latn-por_Latn
hr-ro | hrv_Latn-ron_Latn
hr-ru | hrv_Latn-rus_Cyrl
hr-si | hrv_Latn-sin_Sinh
hr-sk | hrv_Latn-slk_Latn
hr-sl | hrv_Latn-slv_Latn
hr-sq | hrv_Latn-sqi_Latn
hr-sr | hrv_Latn-srp_Cyrl
hr-sv | hrv_Latn-swe_Latn
hr-sw | hrv_Latn-swa_Latn
hr-ta | hrv_Latn-tam_Taml
hr-te | hrv_Latn-tel_Telu
hr-tl | hrv_Latn-tgl_Latn
hr-tr | hrv_Latn-tur_Latn
hr-tt | hrv_Latn-tat_Cyrl
hr-uk | hrv_Latn-ukr_Cyrl
hr-ur | hrv_Latn-urd_Arab
hr-uz | hrv_Latn-uzb_Latn
hr-vi | hrv_Latn-vie_Latn
hr-yue | hrv_Latn-yue_Hant
hr-zh_CN | hrv_Latn-zho_Hans
hr-zh_TW | hrv_Latn-zho_Hant
hr-zh_ze | hrv_Latn-zho_Hans
hu-id | hun_Latn-ind_Latn
hu-is | hun_Latn-isl_Latn
hu-it | hun_Latn-ita_Latn
hu-ka | hun_Latn-kat_Geor
hu-kk | hun_Latn-kaz_Cyrl
hu-km | hun_Latn-khm_Khmr
hu-kn | hun_Latn-kan_Knda
hu-ko | hun_Latn-kor_Hang
hu-ku | hun_Latn-kmr_Latn
hu-lt | hun_Latn-lit_Latn
hu-lv | hun_Latn-lav_Latn
hu-mk | hun_Latn-mkd_Cyrl
hu-ml | hun_Latn-mal_Mlym
hu-mn | hun_Latn-mon_Cyrl
hu-ms | hun_Latn-msa_Latn
hu-my | hun_Latn-mya_Mymr
hu-nl | hun_Latn-nld_Latn
hu-no | hun_Latn-nob_Latn
hu-pl | hun_Latn-pol_Latn
hu-pt_BR | hun_Latn-por_Latn
hu-pt | hun_Latn-por_Latn
hu-ro | hun_Latn-ron_Latn
hu-ru | hun_Latn-rus_Cyrl
hu-si | hun_Latn-sin_Sinh
hu-sk | hun_Latn-slk_Latn
hu-sl | hun_Latn-slv_Latn
hu-sq | hun_Latn-sqi_Latn
hu-sr | hun_Latn-srp_Cyrl
hu-sv | hun_Latn-swe_Latn
hu-sw | hun_Latn-swa_Latn
hu-ta | hun_Latn-tam_Taml
hu-te | hun_Latn-tel_Telu
hu-tl | hun_Latn-tgl_Latn
hu-tr | hun_Latn-tur_Latn
hu-tt | hun_Latn-tat_Cyrl
hu-uk | hun_Latn-ukr_Cyrl
hu-ur | hun_Latn-urd_Arab
hu-uz | hun_Latn-uzb_Latn
hu-vi | hun_Latn-vie_Latn
hu-yue | hun_Latn-yue_Hant
hu-zh_CN | hun_Latn-zho_Hans
hu-zh_TW | hun_Latn-zho_Hant
hu-zh_ze | hun_Latn-zho_Hans
hy-it | hye_Armn-ita_Latn
hy-no | hye_Armn-nob_Latn
hy-pt | hye_Armn-por_Latn
hy-ro | hye_Armn-ron_Latn
hy-ru | hye_Armn-rus_Cyrl
hy-sr | hye_Armn-srp_Cyrl
hy-sv | hye_Armn-swe_Latn
id-is | ind_Latn-isl_Latn
id-it | ind_Latn-ita_Latn
id-ka | ind_Latn-kat_Geor
id-kk | ind_Latn-kaz_Cyrl
id-km | ind_Latn-khm_Khmr
id-kn | ind_Latn-kan_Knda
id-ko | ind_Latn-kor_Hang
id-ku | ind_Latn-kmr_Latn
id-lt | ind_Latn-lit_Latn
id-lv | ind_Latn-lav_Latn
id-mk | ind_Latn-mkd_Cyrl
id-ml | ind_Latn-mal_Mlym
id-mn | ind_Latn-mon_Cyrl
id-ms | ind_Latn-msa_Latn
id-my | ind_Latn-mya_Mymr
id-nl | ind_Latn-nld_Latn
id-no | ind_Latn-nob_Latn
id-pl | ind_Latn-pol_Latn
id-ps | ind_Latn-pus_Arab
id-pt_BR | ind_Latn-por_Latn
id-pt | ind_Latn-por_Latn
id-pt_MZ | ind_Latn-por_Latn
id-ro | ind_Latn-ron_Latn
id-ru | ind_Latn-rus_Cyrl
id-si | ind_Latn-sin_Sinh
id-sk | ind_Latn-slk_Latn
id-sl | ind_Latn-slv_Latn
id-sq | ind_Latn-sqi_Latn
id-sr | ind_Latn-srp_Cyrl
id-sv | ind_Latn-swe_Latn
id-sw | ind_Latn-swa_Latn
id-ta | ind_Latn-tam_Taml
id-te | ind_Latn-tel_Telu
id-tl | ind_Latn-tgl_Latn
id-tr | ind_Latn-tur_Latn
id-tt | ind_Latn-tat_Cyrl
id-uk | ind_Latn-ukr_Cyrl
id-ur | ind_Latn-urd_Arab
id-uz | ind_Latn-uzb_Latn
id-vi | ind_Latn-vie_Latn
id-yue | ind_Latn-yue_Hant
id-zh_CN | ind_Latn-zho_Hans
id-zh_TW | ind_Latn-zho_Hant
id-zh_ze | ind_Latn-zho_Hans
is-it | isl_Latn-ita_Latn
is-ko | isl_Latn-kor_Hang
is-ku | isl_Latn-kmr_Latn
is-lt | isl_Latn-lit_Latn
is-lv | isl_Latn-lav_Latn
is-mk | isl_Latn-mkd_Cyrl
is-ml | isl_Latn-mal_Mlym
is-ms | isl_Latn-msa_Latn
is-my | isl_Latn-mya_Mymr
is-nl | isl_Latn-nld_Latn
is-no | isl_Latn-nob_Latn
is-pl | isl_Latn-pol_Latn
is-pt_BR | isl_Latn-por_Latn
is-pt | isl_Latn-por_Latn
is-ro | isl_Latn-ron_Latn
is-ru | isl_Latn-rus_Cyrl
is-si | isl_Latn-sin_Sinh
is-sk | isl_Latn-slk_Latn
is-sl | isl_Latn-slv_Latn
is-sq | isl_Latn-sqi_Latn
is-sr | isl_Latn-srp_Cyrl
is-sv | isl_Latn-swe_Latn
is-tl | isl_Latn-tgl_Latn
is-tr | isl_Latn-tur_Latn
is-tt | isl_Latn-tat_Cyrl
is-uk | isl_Latn-ukr_Cyrl
is-ur | isl_Latn-urd_Arab
is-vi | isl_Latn-vie_Latn
is-yue | isl_Latn-yue_Hant
is-zh_CN | isl_Latn-zho_Hans
is-zh_TW | isl_Latn-zho_Hant
is-zh_ze | isl_Latn-zho_Hans
it-ka | ita_Latn-kat_Geor
it-kk | ita_Latn-kaz_Cyrl
it-km | ita_Latn-khm_Khmr
it-kn | ita_Latn-kan_Knda
it-ko | ita_Latn-kor_Hang
it-ku | ita_Latn-kmr_Latn
it-lt | ita_Latn-lit_Latn
it-lv | ita_Latn-lav_Latn
it-mk | ita_Latn-mkd_Cyrl
it-ml | ita_Latn-mal_Mlym
it-mn | ita_Latn-mon_Cyrl
it-ms | ita_Latn-msa_Latn
it-my | ita_Latn-mya_Mymr
it-nl | ita_Latn-nld_Latn
it-no | ita_Latn-nob_Latn
it-pl | ita_Latn-pol_Latn
it-pt_BR | ita_Latn-por_Latn
it-pt | ita_Latn-por_Latn
it-ro | ita_Latn-ron_Latn
it-ru | ita_Latn-rus_Cyrl
it-si | ita_Latn-sin_Sinh
it-sk | ita_Latn-slk_Latn
it-sl | ita_Latn-slv_Latn
it-sq | ita_Latn-sqi_Latn
it-sr | ita_Latn-srp_Cyrl
it-sv | ita_Latn-swe_Latn
it-sw | ita_Latn-swa_Latn
it-ta | ita_Latn-tam_Taml
it-te | ita_Latn-tel_Telu
it-tl | ita_Latn-tgl_Latn
it-tr | ita_Latn-tur_Latn
it-tt | ita_Latn-tat_Cyrl
it-uk | ita_Latn-ukr_Cyrl
it-ur | ita_Latn-urd_Arab
it-uz | ita_Latn-uzb_Latn
it-vi | ita_Latn-vie_Latn
it-yue | ita_Latn-yue_Hant
it-zh_CN | ita_Latn-zho_Hans
it-zh_TW | ita_Latn-zho_Hant
it-zh_ze | ita_Latn-zho_Hans
ka-ko | kat_Geor-kor_Hang
ka-ms | kat_Geor-msa_Latn
ka-nl | kat_Geor-nld_Latn
ka-no | kat_Geor-nob_Latn
ka-pl | kat_Geor-pol_Latn
ka-pt_BR | kat_Geor-por_Latn
ka-pt | kat_Geor-por_Latn
ka-ro | kat_Geor-ron_Latn
ka-ru | kat_Geor-rus_Cyrl
ka-sk | kat_Geor-slk_Latn
ka-sr | kat_Geor-srp_Cyrl
ka-sv | kat_Geor-swe_Latn
ka-tr | kat_Geor-tur_Latn
ka-uk | kat_Geor-ukr_Cyrl
ka-vi | kat_Geor-vie_Latn
ka-zh_TW | kat_Geor-zho_Hant
kk-nl | kaz_Cyrl-nld_Latn
kk-pl | kaz_Cyrl-pol_Latn
kk-pt_BR | kaz_Cyrl-por_Latn
kk-pt | kaz_Cyrl-por_Latn
kk-ro | kaz_Cyrl-ron_Latn
kk-ru | kaz_Cyrl-rus_Cyrl
kk-sl | kaz_Cyrl-slv_Latn
kk-sv | kaz_Cyrl-swe_Latn
kk-tr | kaz_Cyrl-tur_Latn
kk-uk | kaz_Cyrl-ukr_Cyrl
kk-vi | kaz_Cyrl-vie_Latn
km-ko | khm_Khmr-kor_Hang
km-ml | khm_Khmr-mal_Mlym
km-ms | khm_Khmr-msa_Latn
km-my | khm_Khmr-mya_Mymr
km-no | khm_Khmr-nob_Latn
km-pl | khm_Khmr-pol_Latn
km-pt | khm_Khmr-por_Latn
km-ro | khm_Khmr-ron_Latn
km-si | khm_Khmr-sin_Sinh
km-sk | khm_Khmr-slk_Latn
km-sr | khm_Khmr-srp_Cyrl
km-sv | khm_Khmr-swe_Latn
km-sw | khm_Khmr-swa_Latn
km-tl | khm_Khmr-tgl_Latn
km-vi | khm_Khmr-vie_Latn
km-zh_TW | khm_Khmr-zho_Hant
kn-ko | kan_Knda-kor_Hang
kn-lv | kan_Knda-lav_Latn
kn-mk | kan_Knda-mkd_Cyrl
kn-ml | kan_Knda-mal_Mlym
kn-ms | kan_Knda-msa_Latn
kn-nl | kan_Knda-nld_Latn
kn-no | kan_Knda-nob_Latn
kn-pl | kan_Knda-pol_Latn
kn-pt_BR | kan_Knda-por_Latn
kn-pt | kan_Knda-por_Latn
kn-ps | kan_Knda-pus_Arab
kn-ro | kan_Knda-ron_Latn
kn-ru | kan_Knda-rus_Cyrl
kn-si | kan_Knda-sin_Sinh
kn-sk | kan_Knda-slk_Latn
kn-sl | kan_Knda-slv_Latn
kn-sq | kan_Knda-sqi_Latn
kn-sr | kan_Knda-srp_Cyrl
kn-sv | kan_Knda-swe_Latn
kn-sw | kan_Knda-swa_Latn
kn-ta | kan_Knda-tam_Taml
kn-te | kan_Knda-tel_Telu
kn-tr | kan_Knda-tur_Latn
kn-ur | kan_Knda-urd_Arab
kn-vi | kan_Knda-vie_Latn
kn-zh_CN | kan_Knda-zho_Hans
kn-zh_TW | kan_Knda-zho_Hant
ko-ku | kor_Hang-kmr_Latn
ko-lt | kor_Hang-lit_Latn
ko-lv | kor_Hang-lav_Latn
ko-mk | kor_Hang-mkd_Cyrl
ko-ml | kor_Hang-mal_Mlym
ko-ms | kor_Hang-msa_Latn
ko-my | kor_Hang-mya_Mymr
ko-nl | kor_Hang-nld_Latn
ko-no | kor_Hang-nob_Latn
ko-pl | kor_Hang-pol_Latn
ko-pt_BR | kor_Hang-por_Latn
ko-pt | kor_Hang-por_Latn
ko-ro | kor_Hang-ron_Latn
ko-ru | kor_Hang-rus_Cyrl
ko-si | kor_Hang-sin_Sinh
ko-sk | kor_Hang-slk_Latn
ko-sl | kor_Hang-slv_Latn
ko-sq | kor_Hang-sqi_Latn
ko-sr | kor_Hang-srp_Cyrl
ko-sv | kor_Hang-swe_Latn
ko-sw | kor_Hang-swa_Latn
ko-ta | kor_Hang-tam_Taml
ko-te | kor_Hang-tel_Telu
ko-tl | kor_Hang-tgl_Latn
ko-tr | kor_Hang-tur_Latn
ko-tt | kor_Hang-tat_Cyrl
ko-uk | kor_Hang-ukr_Cyrl
ko-ur | kor_Hang-urd_Arab
ko-uz | kor_Hang-uzb_Latn
ko-vi | kor_Hang-vie_Latn
ko-yue | kor_Hang-yue_Hant
ko-zh_CN | kor_Hang-zho_Hans
ko-zh_TW | kor_Hang-zho_Hant
ko-zh_ze | kor_Hang-zho_Hans
ku-lt | kmr_Latn-lit_Latn
ku-lv | kmr_Latn-lav_Latn
ku-mk | kmr_Latn-mkd_Cyrl
ku-ml | kmr_Latn-mal_Mlym
ku-ms | kmr_Latn-msa_Latn
ku-my | kmr_Latn-mya_Mymr
ku-nl | kmr_Latn-nld_Latn
ku-no | kmr_Latn-nob_Latn
ku-pl | kmr_Latn-pol_Latn
ku-pt_BR | kmr_Latn-por_Latn
ku-pt | kmr_Latn-por_Latn
ku-ro | kmr_Latn-ron_Latn
ku-ru | kmr_Latn-rus_Cyrl
ku-si | kmr_Latn-sin_Sinh
ku-sk | kmr_Latn-slk_Latn
ku-sl | kmr_Latn-slv_Latn
ku-sq | kmr_Latn-sqi_Latn
ku-sr | kmr_Latn-srp_Cyrl
ku-sv | kmr_Latn-swe_Latn
ku-sw | kmr_Latn-swa_Latn
ku-ta | kmr_Latn-tam_Taml
ku-te | kmr_Latn-tel_Telu
ku-tl | kmr_Latn-tgl_Latn
ku-tr | kmr_Latn-tur_Latn
ku-tt | kmr_Latn-tat_Cyrl
ku-uk | kmr_Latn-ukr_Cyrl
ku-ur | kmr_Latn-urd_Arab
ku-uz | kmr_Latn-uzb_Latn
ku-vi | kmr_Latn-vie_Latn
ku-yue | kmr_Latn-yue_Hant
ku-zh_CN | kmr_Latn-zho_Hans
ku-zh_TW | kmr_Latn-zho_Hant
lt-lv | lit_Latn-lav_Latn
lt-mk | lit_Latn-mkd_Cyrl
lt-ml | lit_Latn-mal_Mlym
lt-mn | lit_Latn-mon_Cyrl
lt-ms | lit_Latn-msa_Latn
lt-my | lit_Latn-mya_Mymr
lt-nl | lit_Latn-nld_Latn
lt-no | lit_Latn-nob_Latn
lt-pl | lit_Latn-pol_Latn
lt-pt_BR | lit_Latn-por_Latn
lt-pt | lit_Latn-por_Latn
lt-ro | lit_Latn-ron_Latn
lt-ru | lit_Latn-rus_Cyrl
lt-si | lit_Latn-sin_Sinh
lt-sk | lit_Latn-slk_Latn
lt-sl | lit_Latn-slv_Latn
lt-sq | lit_Latn-sqi_Latn
lt-sr | lit_Latn-srp_Cyrl
lt-sv | lit_Latn-swe_Latn
lt-ta | lit_Latn-tam_Taml
lt-te | lit_Latn-tel_Telu
lt-tl | lit_Latn-tgl_Latn
lt-tr | lit_Latn-tur_Latn
lt-tt | lit_Latn-tat_Cyrl
lt-uk | lit_Latn-ukr_Cyrl
lt-ur | lit_Latn-urd_Arab
lt-uz | lit_Latn-uzb_Latn
lt-vi | lit_Latn-vie_Latn
lt-yue | lit_Latn-yue_Hant
lt-zh_CN | lit_Latn-zho_Hans
lt-zh_TW | lit_Latn-zho_Hant
lt-zh_ze | lit_Latn-zho_Hans
lv-mk | lav_Latn-mkd_Cyrl
lv-ml | lav_Latn-mal_Mlym
lv-mn | lav_Latn-mon_Cyrl
lv-ms | lav_Latn-msa_Latn
lv-my | lav_Latn-mya_Mymr
lv-nl | lav_Latn-nld_Latn
lv-no | lav_Latn-nob_Latn
lv-pl | lav_Latn-pol_Latn
lv-pt_BR | lav_Latn-por_Latn
lv-pt | lav_Latn-por_Latn
lv-ro | lav_Latn-ron_Latn
lv-ru | lav_Latn-rus_Cyrl
lv-si | lav_Latn-sin_Sinh
lv-sk | lav_Latn-slk_Latn
lv-sl | lav_Latn-slv_Latn
lv-sq | lav_Latn-sqi_Latn
lv-sr | lav_Latn-srp_Cyrl
lv-sv | lav_Latn-swe_Latn
lv-ta | lav_Latn-tam_Taml
lv-te | lav_Latn-tel_Telu
lv-tl | lav_Latn-tgl_Latn
lv-tr | lav_Latn-tur_Latn
lv-tt | lav_Latn-tat_Cyrl
lv-uk | lav_Latn-ukr_Cyrl
lv-ur | lav_Latn-urd_Arab
lv-uz | lav_Latn-uzb_Latn
lv-vi | lav_Latn-vie_Latn
lv-yue | lav_Latn-yue_Hant
lv-zh_CN | lav_Latn-zho_Hans
lv-zh_TW | lav_Latn-zho_Hant
lv-zh_ze | lav_Latn-zho_Hans
mk-ml | mkd_Cyrl-mal_Mlym
mk-mn | mkd_Cyrl-mon_Cyrl
mk-ms | mkd_Cyrl-msa_Latn
mk-my | mkd_Cyrl-mya_Mymr
mk-nl | mkd_Cyrl-nld_Latn
mk-no | mkd_Cyrl-nob_Latn
mk-pl | mkd_Cyrl-pol_Latn
mk-pt_BR | mkd_Cyrl-por_Latn
mk-pt | mkd_Cyrl-por_Latn
mk-ro | mkd_Cyrl-ron_Latn
mk-ru | mkd_Cyrl-rus_Cyrl
mk-si | mkd_Cyrl-sin_Sinh
mk-sk | mkd_Cyrl-slk_Latn
mk-sl | mkd_Cyrl-slv_Latn
mk-sq | mkd_Cyrl-sqi_Latn
mk-sr | mkd_Cyrl-srp_Cyrl
mk-sv | mkd_Cyrl-swe_Latn
mk-ta | mkd_Cyrl-tam_Taml
mk-te | mkd_Cyrl-tel_Telu
mk-tl | mkd_Cyrl-tgl_Latn
mk-tr | mkd_Cyrl-tur_Latn
mk-tt | mkd_Cyrl-tat_Cyrl
mk-uk | mkd_Cyrl-ukr_Cyrl
mk-ur | mkd_Cyrl-urd_Arab
mk-uz | mkd_Cyrl-uzb_Latn
mk-vi | mkd_Cyrl-vie_Latn
mk-yue | mkd_Cyrl-yue_Hant
mk-zh_CN | mkd_Cyrl-zho_Hans
mk-zh_TW | mkd_Cyrl-zho_Hant
mk-zh_ze | mkd_Cyrl-zho_Hans
ml-ms | mal_Mlym-msa_Latn
ml-my | mal_Mlym-mya_Mymr
ml-nl | mal_Mlym-nld_Latn
ml-no | mal_Mlym-nob_Latn
ml-pl | mal_Mlym-pol_Latn
ml-pt_BR | mal_Mlym-por_Latn
ml-pt | mal_Mlym-por_Latn
ml-ro | mal_Mlym-ron_Latn
ml-ru | mal_Mlym-rus_Cyrl
ml-si | mal_Mlym-sin_Sinh
ml-sk | mal_Mlym-slk_Latn
ml-sl | mal_Mlym-slv_Latn
ml-sq | mal_Mlym-sqi_Latn
ml-sr | mal_Mlym-srp_Cyrl
ml-sv | mal_Mlym-swe_Latn
ml-sw | mal_Mlym-swa_Latn
ml-ta | mal_Mlym-tam_Taml
ml-te | mal_Mlym-tel_Telu
ml-tl | mal_Mlym-tgl_Latn
ml-tr | mal_Mlym-tur_Latn
ml-tt | mal_Mlym-tat_Cyrl
ml-uk | mal_Mlym-ukr_Cyrl
ml-ur | mal_Mlym-urd_Arab
ml-vi | mal_Mlym-vie_Latn
ml-yue | mal_Mlym-yue_Hant
ml-zh_CN | mal_Mlym-zho_Hans
ml-zh_TW | mal_Mlym-zho_Hant
ml-zh_ze | mal_Mlym-zho_Hans
mn-ms | mon_Cyrl-msa_Latn
mn-nl | mon_Cyrl-nld_Latn
mn-no | mon_Cyrl-nob_Latn
mn-pl | mon_Cyrl-pol_Latn
mn-pt_BR | mon_Cyrl-por_Latn
mn-pt | mon_Cyrl-por_Latn
mn-ro | mon_Cyrl-ron_Latn
mn-ru | mon_Cyrl-rus_Cyrl
mn-sk | mon_Cyrl-slk_Latn
mn-sl | mon_Cyrl-slv_Latn
mn-sr | mon_Cyrl-srp_Cyrl
mn-sv | mon_Cyrl-swe_Latn
mn-tr | mon_Cyrl-tur_Latn
mn-uk | mon_Cyrl-ukr_Cyrl
mn-vi | mon_Cyrl-vie_Latn
mn-zh_CN | mon_Cyrl-zho_Hans
mn-zh_TW | mon_Cyrl-zho_Hant
ms-my | msa_Latn-mya_Mymr
ms-nl | msa_Latn-nld_Latn
ms-no | msa_Latn-nob_Latn
ms-pl | msa_Latn-pol_Latn
ms-pt_BR | msa_Latn-por_Latn
ms-pt | msa_Latn-por_Latn
ms-ro | msa_Latn-ron_Latn
ms-ru | msa_Latn-rus_Cyrl
ms-si | msa_Latn-sin_Sinh
ms-sk | msa_Latn-slk_Latn
ms-sl | msa_Latn-slv_Latn
ms-sq | msa_Latn-sqi_Latn
ms-sr | msa_Latn-srp_Cyrl
ms-sv | msa_Latn-swe_Latn
ms-sw | msa_Latn-swa_Latn
ms-ta | msa_Latn-tam_Taml
ms-te | msa_Latn-tel_Telu
ms-tl | msa_Latn-tgl_Latn
ms-tr | msa_Latn-tur_Latn
ms-tt | msa_Latn-tat_Cyrl
ms-uk | msa_Latn-ukr_Cyrl
ms-ur | msa_Latn-urd_Arab
ms-vi | msa_Latn-vie_Latn
ms-yue | msa_Latn-yue_Hant
ms-zh_CN | msa_Latn-zho_Hans
ms-zh_TW | msa_Latn-zho_Hant
ms-zh_ze | msa_Latn-zho_Hans
my-nl | mya_Mymr-nld_Latn
my-no | mya_Mymr-nob_Latn
my-pl | mya_Mymr-pol_Latn
my-pt_BR | mya_Mymr-por_Latn
my-pt | mya_Mymr-por_Latn
my-ro | mya_Mymr-ron_Latn
my-ru | mya_Mymr-rus_Cyrl
my-si | mya_Mymr-sin_Sinh
my-sk | mya_Mymr-slk_Latn
my-sl | mya_Mymr-slv_Latn
my-sq | mya_Mymr-sqi_Latn
my-sr | mya_Mymr-srp_Cyrl
my-sv | mya_Mymr-swe_Latn
my-sw | mya_Mymr-swa_Latn
my-te | mya_Mymr-tel_Telu
my-tl | mya_Mymr-tgl_Latn
my-tr | mya_Mymr-tur_Latn
my-uk | mya_Mymr-ukr_Cyrl
my-vi | mya_Mymr-vie_Latn
my-yue | mya_Mymr-yue_Hant
my-zh_CN | mya_Mymr-zho_Hans
my-zh_TW | mya_Mymr-zho_Hant
my-zh_ze | mya_Mymr-zho_Hans
nl-no | nld_Latn-nob_Latn
nl-pl | nld_Latn-pol_Latn
nl-pt_BR | nld_Latn-por_Latn
nl-pt | nld_Latn-por_Latn
nl-pt_MZ | nld_Latn-por_Latn
nl-ro | nld_Latn-ron_Latn
nl-ru | nld_Latn-rus_Cyrl
nl-si | nld_Latn-sin_Sinh
nl-sk | nld_Latn-slk_Latn
nl-sl | nld_Latn-slv_Latn
nl-sq | nld_Latn-sqi_Latn
nl-sr | nld_Latn-srp_Cyrl
nl-sv | nld_Latn-swe_Latn
nl-ta | nld_Latn-tam_Taml
nl-te | nld_Latn-tel_Telu
nl-tl | nld_Latn-tgl_Latn
nl-tr | nld_Latn-tur_Latn
nl-tt | nld_Latn-tat_Cyrl
nl-uk | nld_Latn-ukr_Cyrl
nl-ur | nld_Latn-urd_Arab
nl-uz | nld_Latn-uzb_Latn
nl-vi | nld_Latn-vie_Latn
nl-yue | nld_Latn-yue_Hant
nl-zh_CN | nld_Latn-zho_Hans
nl-zh_TW | nld_Latn-zho_Hant
nl-zh_ze | nld_Latn-zho_Hans
no-pl | nob_Latn-pol_Latn
no-pt_BR | nob_Latn-por_Latn
no-pt | nob_Latn-por_Latn
no-ro | nob_Latn-ron_Latn
no-ru | nob_Latn-rus_Cyrl
no-si | nob_Latn-sin_Sinh
no-sk | nob_Latn-slk_Latn
no-sl | nob_Latn-slv_Latn
no-sq | nob_Latn-sqi_Latn
no-sr | nob_Latn-srp_Cyrl
no-sv | nob_Latn-swe_Latn
no-sw | nob_Latn-swa_Latn
no-ta | nob_Latn-tam_Taml
no-te | nob_Latn-tel_Telu
no-tl | nob_Latn-tgl_Latn
no-tr | nob_Latn-tur_Latn
no-tt | nob_Latn-tat_Cyrl
no-uk | nob_Latn-ukr_Cyrl
no-ur | nob_Latn-urd_Arab
no-vi | nob_Latn-vie_Latn
no-yue | nob_Latn-yue_Hant
no-zh_CN | nob_Latn-zho_Hans
no-zh_TW | nob_Latn-zho_Hant
no-zh_ze | nob_Latn-zho_Hans
pl-pt_BR | pol_Latn-por_Latn
pl-pt | pol_Latn-por_Latn
pl-ro | pol_Latn-ron_Latn
pl-ru | pol_Latn-rus_Cyrl
pl-si | pol_Latn-sin_Sinh
pl-sk | pol_Latn-slk_Latn
pl-sl | pol_Latn-slv_Latn
pl-sq | pol_Latn-sqi_Latn
pl-sr | pol_Latn-srp_Cyrl
pl-sv | pol_Latn-swe_Latn
pl-sw | pol_Latn-swa_Latn
pl-ta | pol_Latn-tam_Taml
pl-te | pol_Latn-tel_Telu
pl-tl | pol_Latn-tgl_Latn
pl-tr | pol_Latn-tur_Latn
pl-tt | pol_Latn-tat_Cyrl
pl-uk | pol_Latn-ukr_Cyrl
pl-ur | pol_Latn-urd_Arab
pl-uz | pol_Latn-uzb_Latn
pl-vi | pol_Latn-vie_Latn
pl-yue | pol_Latn-yue_Hant
pl-zh_CN | pol_Latn-zho_Hans
pl-zh_TW | pol_Latn-zho_Hant
pl-zh_ze | pol_Latn-zho_Hans
ps-si | pus_Arab-sin_Sinh
ps-sw | pus_Arab-swa_Latn
ps-ur | pus_Arab-urd_Arab
pt_BR-ro | por_Latn-ron_Latn
pt_BR-ru | por_Latn-rus_Cyrl
pt_BR-si | por_Latn-sin_Sinh
pt_BR-sk | por_Latn-slk_Latn
pt_BR-sl | por_Latn-slv_Latn
pt_BR-sq | por_Latn-sqi_Latn
pt_BR-sr | por_Latn-srp_Cyrl
pt_BR-sv | por_Latn-swe_Latn
pt_BR-sw | por_Latn-swa_Latn
pt_BR-ta | por_Latn-tam_Taml
pt_BR-te | por_Latn-tel_Telu
pt_BR-tl | por_Latn-tgl_Latn
pt_BR-tr | por_Latn-tur_Latn
pt_BR-tt | por_Latn-tat_Cyrl
pt_BR-uk | por_Latn-ukr_Cyrl
pt_BR-ur | por_Latn-urd_Arab
pt_BR-uz | por_Latn-uzb_Latn
pt_BR-vi | por_Latn-vie_Latn
pt_BR-yue | por_Latn-yue_Hant
pt_BR-zh_CN | por_Latn-zho_Hans
pt_BR-zh_TW | por_Latn-zho_Hant
pt_BR-zh_ze | por_Latn-zho_Hans
pt_MZ-ro | por_Latn-ron_Latn
pt_MZ-ru | por_Latn-rus_Cyrl
pt_MZ-sv | por_Latn-swe_Latn
pt_MZ-tr | por_Latn-tur_Latn
pt_MZ-vi | por_Latn-vie_Latn
pt_MZ-zh_CN | por_Latn-zho_Hans
pt_MZ-zh_TW | por_Latn-zho_Hant
pt-pt_BR | por_Latn-por_Latn
pt-pt_MZ | por_Latn-por_Latn
pt-ro | por_Latn-ron_Latn
pt-ru | por_Latn-rus_Cyrl
pt-si | por_Latn-sin_Sinh
pt-sk | por_Latn-slk_Latn
pt-sl | por_Latn-slv_Latn
pt-sq | por_Latn-sqi_Latn
pt-sr | por_Latn-srp_Cyrl
pt-sv | por_Latn-swe_Latn
pt-sw | por_Latn-swa_Latn
pt-ta | por_Latn-tam_Taml
pt-te | por_Latn-tel_Telu
pt-tl | por_Latn-tgl_Latn
pt-tr | por_Latn-tur_Latn
pt-tt | por_Latn-tat_Cyrl
pt-uk | por_Latn-ukr_Cyrl
pt-ur | por_Latn-urd_Arab
pt-uz | por_Latn-uzb_Latn
pt-vi | por_Latn-vie_Latn
pt-yue | por_Latn-yue_Hant
pt-zh_CN | por_Latn-zho_Hans
pt-zh_TW | por_Latn-zho_Hant
pt-zh_ze | por_Latn-zho_Hans
ro-ru | ron_Latn-rus_Cyrl
ro-si | ron_Latn-sin_Sinh
ro-sk | ron_Latn-slk_Latn
ro-sl | ron_Latn-slv_Latn
ro-sq | ron_Latn-sqi_Latn
ro-sr | ron_Latn-srp_Cyrl
ro-sv | ron_Latn-swe_Latn
ro-sw | ron_Latn-swa_Latn
ro-ta | ron_Latn-tam_Taml
ro-te | ron_Latn-tel_Telu
ro-tl | ron_Latn-tgl_Latn
ro-tr | ron_Latn-tur_Latn
ro-tt | ron_Latn-tat_Cyrl
ro-uk | ron_Latn-ukr_Cyrl
ro-ur | ron_Latn-urd_Arab
ro-uz | ron_Latn-uzb_Latn
ro-vi | ron_Latn-vie_Latn
ro-yue | ron_Latn-yue_Hant
ro-zh_CN | ron_Latn-zho_Hans
ro-zh_TW | ron_Latn-zho_Hant
ro-zh_ze | ron_Latn-zho_Hans
ru-si | rus_Cyrl-sin_Sinh
ru-sk | rus_Cyrl-slk_Latn
ru-sl | rus_Cyrl-slv_Latn
ru-sq | rus_Cyrl-sqi_Latn
ru-sr | rus_Cyrl-srp_Cyrl
ru-sv | rus_Cyrl-swe_Latn
ru-sw | rus_Cyrl-swa_Latn
ru-ta | rus_Cyrl-tam_Taml
ru-te | rus_Cyrl-tel_Telu
ru-tl | rus_Cyrl-tgl_Latn
ru-tr | rus_Cyrl-tur_Latn
ru-tt | rus_Cyrl-tat_Cyrl
ru-uk | rus_Cyrl-ukr_Cyrl
ru-ur | rus_Cyrl-urd_Arab
ru-uz | rus_Cyrl-uzb_Latn
ru-vi | rus_Cyrl-vie_Latn
ru-yue | rus_Cyrl-yue_Hant
ru-zh_CN | rus_Cyrl-zho_Hans
ru-zh_TW | rus_Cyrl-zho_Hant
ru-zh_ze | rus_Cyrl-zho_Hans
si-sk | sin_Sinh-slk_Latn
si-sl | sin_Sinh-slv_Latn
si-sq | sin_Sinh-sqi_Latn
si-sr | sin_Sinh-srp_Cyrl
si-sv | sin_Sinh-swe_Latn
si-sw | sin_Sinh-swa_Latn
si-ta | sin_Sinh-tam_Taml
si-te | sin_Sinh-tel_Telu
si-tl | sin_Sinh-tgl_Latn
si-tr | sin_Sinh-tur_Latn
si-tt | sin_Sinh-tat_Cyrl
si-uk | sin_Sinh-ukr_Cyrl
si-ur | sin_Sinh-urd_Arab
si-vi | sin_Sinh-vie_Latn
si-yue | sin_Sinh-yue_Hant
si-zh_CN | sin_Sinh-zho_Hans
si-zh_TW | sin_Sinh-zho_Hant
si-zh_ze | sin_Sinh-zho_Hans
sk-sl | slk_Latn-slv_Latn
sk-sq | slk_Latn-sqi_Latn
sk-sr | slk_Latn-srp_Cyrl
sk-sv | slk_Latn-swe_Latn
sk-sw | slk_Latn-swa_Latn
sk-ta | slk_Latn-tam_Taml
sk-te | slk_Latn-tel_Telu
sk-tl | slk_Latn-tgl_Latn
sk-tr | slk_Latn-tur_Latn
sk-tt | slk_Latn-tat_Cyrl
sk-uk | slk_Latn-ukr_Cyrl
sk-ur | slk_Latn-urd_Arab
sk-vi | slk_Latn-vie_Latn
sk-yue | slk_Latn-yue_Hant
sk-zh_CN | slk_Latn-zho_Hans
sk-zh_TW | slk_Latn-zho_Hant
sk-zh_ze | slk_Latn-zho_Hans
sl-sq | slv_Latn-sqi_Latn
sl-sr | slv_Latn-srp_Cyrl
sl-sv | slv_Latn-swe_Latn
sl-sw | slv_Latn-swa_Latn
sl-ta | slv_Latn-tam_Taml
sl-te | slv_Latn-tel_Telu
sl-tl | slv_Latn-tgl_Latn
sl-tr | slv_Latn-tur_Latn
sl-tt | slv_Latn-tat_Cyrl
sl-uk | slv_Latn-ukr_Cyrl
sl-ur | slv_Latn-urd_Arab
sl-vi | slv_Latn-vie_Latn
sl-yue | slv_Latn-yue_Hant
sl-zh_CN | slv_Latn-zho_Hans
sl-zh_TW | slv_Latn-zho_Hant
sl-zh_ze | slv_Latn-zho_Hans
sq-sr | sqi_Latn-srp_Cyrl
sq-sv | sqi_Latn-swe_Latn
sq-sw | sqi_Latn-swa_Latn
sq-ta | sqi_Latn-tam_Taml
sq-te | sqi_Latn-tel_Telu
sq-tl | sqi_Latn-tgl_Latn
sq-tr | sqi_Latn-tur_Latn
sq-uk | sqi_Latn-ukr_Cyrl
sq-ur | sqi_Latn-urd_Arab
sq-vi | sqi_Latn-vie_Latn
sq-yue | sqi_Latn-yue_Hant
sq-zh_CN | sqi_Latn-zho_Hans
sq-zh_TW | sqi_Latn-zho_Hant
sr-sv | srp_Cyrl-swe_Latn
sr-sw | srp_Cyrl-swa_Latn
sr-ta | srp_Cyrl-tam_Taml
sr-te | srp_Cyrl-tel_Telu
sr-tl | srp_Cyrl-tgl_Latn
sr-tr | srp_Cyrl-tur_Latn
sr-tt | srp_Cyrl-tat_Cyrl
sr-uk | srp_Cyrl-ukr_Cyrl
sr-ur | srp_Cyrl-urd_Arab
sr-vi | srp_Cyrl-vie_Latn
sr-yue | srp_Cyrl-yue_Hant
sr-zh_CN | srp_Cyrl-zho_Hans
sr-zh_TW | srp_Cyrl-zho_Hant
sr-zh_ze | srp_Cyrl-zho_Hans
sv-sw | swe_Latn-swa_Latn
sv-ta | swe_Latn-tam_Taml
sv-te | swe_Latn-tel_Telu
sv-tl | swe_Latn-tgl_Latn
sv-tr | swe_Latn-tur_Latn
sv-tt | swe_Latn-tat_Cyrl
sv-uk | swe_Latn-ukr_Cyrl
sv-ur | swe_Latn-urd_Arab
sv-vi | swe_Latn-vie_Latn
sv-yue | swe_Latn-yue_Hant
sv-zh_CN | swe_Latn-zho_Hans
sv-zh_TW | swe_Latn-zho_Hant
sv-zh_ze | swe_Latn-zho_Hans
sw-te | swa_Latn-tel_Telu
sw-tl | swa_Latn-tgl_Latn
sw-tr | swa_Latn-tur_Latn
sw-zh_TW | swa_Latn-zho_Hant
ta-te | tam_Taml-tel_Telu
ta-tl | tam_Taml-tgl_Latn
ta-tr | tam_Taml-tur_Latn
ta-uk | tam_Taml-ukr_Cyrl
ta-ur | tam_Taml-urd_Arab
ta-vi | tam_Taml-vie_Latn
ta-yue | tam_Taml-yue_Hant
ta-zh_CN | tam_Taml-zho_Hans
ta-zh_TW | tam_Taml-zho_Hant
ta-zh_ze | tam_Taml-zho_Hans
te-tl | tel_Telu-tgl_Latn
te-tr | tel_Telu-tur_Latn
te-uk | tel_Telu-ukr_Cyrl
te-ur | tel_Telu-urd_Arab
te-vi | tel_Telu-vie_Latn
te-yue | tel_Telu-yue_Hant
te-zh_CN | tel_Telu-zho_Hans
te-zh_TW | tel_Telu-zho_Hant
te-zh_ze | tel_Telu-zho_Hans
tl-tr | tgl_Latn-tur_Latn
tl-uk | tgl_Latn-ukr_Cyrl
tl-ur | tgl_Latn-urd_Arab
tl-vi | tgl_Latn-vie_Latn
tl-zh_CN | tgl_Latn-zho_Hans
tl-zh_TW | tgl_Latn-zho_Hant
tr-tt | tur_Latn-tat_Cyrl
tr-uk | tur_Latn-ukr_Cyrl
tr-ur | tur_Latn-urd_Arab
tr-uz | tur_Latn-uzb_Latn
tr-vi | tur_Latn-vie_Latn
tr-yue | tur_Latn-yue_Hant
tr-zh_CN | tur_Latn-zho_Hans
tr-zh_TW | tur_Latn-zho_Hant
tr-zh_ze | tur_Latn-zho_Hans
tt-uk | tat_Cyrl-ukr_Cyrl
tt-vi | tat_Cyrl-vie_Latn
tt-yue | tat_Cyrl-yue_Hant
tt-zh_CN | tat_Cyrl-zho_Hans
tt-zh_TW | tat_Cyrl-zho_Hant
tt-zh_ze | tat_Cyrl-zho_Hans
uk-ur | ukr_Cyrl-urd_Arab
uk-uz | ukr_Cyrl-uzb_Latn
uk-vi | ukr_Cyrl-vie_Latn
uk-yue | ukr_Cyrl-yue_Hant
uk-zh_CN | ukr_Cyrl-zho_Hans
uk-zh_TW | ukr_Cyrl-zho_Hant
uk-zh_ze | ukr_Cyrl-zho_Hans
ur-vi | urd_Arab-vie_Latn
ur-zh_CN | urd_Arab-zho_Hans
ur-zh_TW | urd_Arab-zho_Hant
uz-zh_TW | uzb_Latn-zho_Hant
vi-yue | vie_Latn-yue_Hant
vi-zh_CN | vie_Latn-zho_Hans
vi-zh_TW | vie_Latn-zho_Hant
vi-zh_ze | vie_Latn-zho_Hans
yue-zh_CN | yue_Hant-zho_Hans
yue-zh_TW | yue_Hant-zho_Hant
yue-zh_ze | yue_Hant-zho_Hans
zh_CN-zh_TW | zho_Hans-zho_Hant
zh_CN-zh_ze | zho_Hans-zho_Hans
zh_TW-zh_ze | zho_Hant-zho_Hans